USER 1,USER 2,MOVIE,RATING 1,RATING 2,DIFFERENCE
30,34429,108399,7,8,1
30,6623,102803,4,7,3
30,34413,96256,7,9,2
30,7706,112818,8,9,1
30,32597,98253,8,8,0
33,27909,87544,7,9,2
36,34449,68646,8,10,2
36,17801,105695,8,9,1
36,14972,57590,5,5,0
40,1057,109830,8,8,0
40,33390,108399,6,5,1
46,34593,78748,7,10,3
46,17624,94226,6,8,2
46,17800,78788,9,10,1
46,8050,95765,7,8,1
46,8050,97216,9,9,0
46,4095,91167,8,9,1
46,22900,104466,9,9,0
46,5287,97123,8,7,1
53,19653,110912,10,8,2
53,34565,87544,7,9,2
76,474,112471,1,8,7
76,32232,94963,3,5,2
76,7985,93773,8,10,2
76,22502,98635,9,10,1
76,10186,106977,10,8,2
76,31979,105665,8,7,1
76,3673,87050,6,6,0
124,11506,110912,4,10,6
124,16452,102926,9,9,0
133,4350,93437,10,10,0
133,13801,112642,10,4,6
146,7292,87544,7,7,0
177,27944,111161,10,10,0
177,14185,109830,10,8,2
177,1490,110912,10,1,9
191,1046,110413,7,9,2
191,1486,111161,9,9,0
198,29976,111503,8,7,1
211,15124,111686,10,8,2
221,468,86250,8,9,1
221,775,99674,8,10,2
280,28050,112864,9,9,0
290,31460,110632,7,6,1
290,21238,111161,9,10,1
290,4623,95953,7,10,3
290,18785,104070,7,9,2
290,18785,112462,5,7,2
290,6623,96061,7,8,1
295,33670,90605,10,10,0
295,11009,94008,10,7,3
295,11009,100403,10,7,3
295,10579,93773,10,10,0
295,20446,91554,10,6,4
302,13923,112740,9,8,1
302,11009,112384,9,9,0
308,33095,88763,9,7,2
314,18098,77651,10,6,4
314,4246,82495,10,6,4
316,25658,91480,9,6,3
331,1182,96895,8,7,1
331,1182,103776,8,6,2
331,13394,81398,8,10,2
336,16556,107818,10,8,2
336,8780,112573,8,10,2
336,16716,112792,7,7,0
336,23588,112401,10,10,0
341,20546,103064,8,10,2
341,26902,92005,9,10,1
341,26902,107290,7,10,3
341,30239,101414,8,8,0
341,13376,107034,8,6,2
341,32032,98384,6,9,3
344,15604,103064,10,10,0
344,15604,110912,10,10,0
344,5991,112641,10,9,1
344,7911,110322,10,4,6
373,16323,105236,8,6,2
373,7029,99685,10,7,3
406,20274,105323,8,9,1
406,29058,113277,9,7,2
406,9178,107822,9,8,1
408,35380,109830,9,10,1
415,4622,86637,9,9,0
415,35750,71141,10,10,0
415,27619,89853,9,9,0
415,27909,69467,9,10,1
415,27909,73312,8,7,1
415,27888,85794,9,7,2
415,21230,63555,7,7,0
427,14157,93389,8,8,0
430,10279,111161,9,10,1
437,6773,105236,7,9,2
437,15529,110413,9,9,0
468,6623,99487,9,7,2
474,11443,105695,9,9,0
474,34397,112471,8,8,0
549,3429,106469,8,10,2
549,4552,110912,8,10,2
555,30946,109830,9,8,1
555,30946,111161,10,9,1
555,16485,110357,8,9,1
577,3187,103060,6,8,2
609,10984,109686,8,7,1
609,7103,94291,9,10,1
628,28050,95016,10,9,1
628,28050,99423,7,8,1
628,28050,112864,8,9,1
664,26596,78788,9,9,0
664,14157,78748,7,8,1
695,17844,99785,10,9,1
695,13376,89670,8,7,1
711,15904,112471,9,8,1
711,15124,111070,6,7,1
711,4302,106918,7,7,0
713,22744,79574,5,6,1
713,22744,86034,7,7,0
713,22744,97742,7,6,1
713,22744,113189,7,8,1
721,261,99685,8,8,0
721,24545,85794,8,8,0
727,1115,104409,10,6,4
740,34565,83922,6,6,0
766,8780,68646,10,10,0
766,8780,111161,10,10,0
775,221,99674,10,8,2
775,20098,110357,10,9,1
808,22404,95016,10,7,3
808,406,102926,9,9,0
808,7529,109506,10,10,0
827,25549,101410,9,7,2
827,32597,79470,8,7,1
827,21230,73312,8,7,1
827,31934,97904,7,8,1
827,8701,71487,9,8,1
853,26744,107207,10,8,2
855,22905,99674,6,9,3
855,30239,108052,10,10,0
855,4137,105236,9,9,0
855,25404,97733,9,8,1
855,25404,98206,3,8,5
866,7315,110912,9,10,1
885,21082,109830,9,9,0
951,10579,91419,10,7,3
957,14730,110912,9,10,1
957,18696,105112,7,7,0
957,13061,103064,9,10,1
957,26808,109040,7,7,0
957,17801,105793,8,7,1
957,23884,111756,5,8,3
957,20195,109045,7,8,1
963,29189,113189,7,10,3
963,1617,112641,7,7,0
963,35477,88847,8,8,0
963,2788,110413,9,9,0
1010,13648,88846,6,7,1
1010,6401,93191,9,10,1
1010,14241,95765,8,10,2
1010,24991,96283,9,8,1
1010,32597,81505,7,7,0
1010,28138,110912,8,10,2
1035,13759,105695,7,10,3
1035,16716,94012,6,6,0
1043,6905,88847,10,10,0
1043,22393,61722,9,9,0
1046,26630,110413,9,8,1
1046,31830,105236,8,7,1
1057,6821,111161,10,8,2
1089,27839,112864,8,8,0
1089,13907,110912,10,9,1
1089,6239,105236,8,9,1
1089,11081,103776,7,7,0
1089,22744,113189,6,8,2
1089,10579,107688,8,10,2
1089,34477,104691,7,8,1
1089,9145,102138,8,9,1
1115,11543,104409,6,6,0
1134,22423,69467,7,9,2
1134,12619,67445,5,10,5
1136,20546,111282,8,8,0
1136,32539,103772,10,6,4
1136,33711,112819,10,7,3
1179,16806,82846,7,9,2
1179,12348,58331,6,10,4
1182,4879,108052,8,8,0
1182,2684,112462,7,10,3
1210,12420,105665,6,7,1
1210,35504,91042,7,8,1
1210,14447,97239,8,5,3
1216,15648,113409,6,3,3
1216,35926,109707,10,8,2
1234,12249,112471,10,10,0
1234,15632,112384,8,7,1
1241,28698,113247,8,7,1
1241,18304,90756,9,8,1
1241,27909,87884,10,10,0
1241,27909,102536,8,8,0
1241,33653,76759,9,9,0
1241,33653,80684,9,8,1
1241,32495,77405,8,8,0
1241,21042,106519,9,9,0
1241,11009,82340,4,8,4
1241,31358,83907,2,8,6
1241,8050,87800,7,6,1
1241,2309,104036,9,7,2
1241,32570,88184,6,7,1
1253,20433,66921,9,9,0
1253,11009,101410,8,8,0
1266,19185,99700,6,8,2
1266,15968,100403,6,8,2
1275,28142,103767,3,7,4
1275,12652,96895,8,7,1
1278,10018,112471,10,10,0
1289,15715,108052,10,10,0
1289,15644,111161,10,10,0
1292,28839,107207,9,7,2
1292,963,110413,9,9,0
1292,21261,97937,9,8,1
1328,5971,106677,6,7,1
1353,13937,108052,10,7,3
1355,17078,110912,5,10,5
1365,11443,105695,9,9,0
1365,11443,110912,9,10,1
1365,34849,108358,8,10,2
1372,9283,108160,6,10,4
1372,19262,86879,10,10,0
1372,22475,71877,8,6,2
1401,13793,107290,8,10,2
1411,24825,103064,9,10,1
1411,11749,100403,9,4,5
1425,24277,95765,6,10,4
1425,32597,62229,8,10,2
1425,19260,60827,4,10,6
1425,33435,113247,2,8,6
1425,19262,80745,8,10,2
1425,8050,61512,8,8,0
1425,8050,93191,7,8,1
1425,32570,63462,5,8,3
1425,22628,79285,6,5,1
1425,4859,69293,7,8,1
1425,4859,108550,5,8,3
1425,31613,76759,8,8,0
1425,31613,80684,8,7,1
1425,27137,110832,8,7,1
1430,889,99700,7,7,0
1430,27357,97165,7,10,3
1430,10382,102926,8,8,0
1430,13793,104409,5,6,1
1430,23215,107818,7,9,2
1430,15968,96928,6,7,1
1430,18077,101507,8,9,1
1441,3187,107120,9,8,1
1443,30946,110413,8,9,1
1443,34044,112817,9,10,1
1449,11491,105236,8,10,2
1449,19562,102926,9,8,1
1449,22819,103874,5,10,5
1449,30431,99810,7,7,0
1449,5754,110357,10,9,1
1449,19185,107290,9,10,1
1449,28914,108052,10,8,2
1449,19262,98635,6,7,1
1449,35477,110005,5,8,3
1449,12928,111257,8,8,0
1449,21109,113568,9,5,4
1449,26902,112697,8,9,1
1449,18785,104815,7,10,3
1449,18785,112851,6,9,3
1456,16401,86879,10,9,1
1456,14157,104691,9,8,1
1486,191,111161,9,9,0
1486,1813,108052,10,10,0
1488,2731,107207,10,7,3
1488,2731,113277,9,7,2
1488,4623,110413,10,10,0
1488,11382,105323,9,8,1
1488,32228,112641,9,8,1
1490,1796,109830,8,8,0
1490,16556,110912,1,7,6
1492,16616,105236,9,6,3
1492,20937,93058,7,9,2
1492,11497,97937,10,7,3
1492,1817,99077,8,6,2
1492,27909,87544,9,9,0
1492,14157,95675,7,7,0
1530,11200,110912,9,10,1
1540,437,105236,8,7,1
1540,11506,110912,10,10,0
1540,11942,93058,9,9,0
1540,24572,108399,8,8,0
1540,20106,106977,8,8,0
1540,13021,113101,6,10,4
1555,11707,100258,9,7,2
1570,11009,106582,8,8,0
1610,20446,89424,10,9,1
1617,8162,94737,7,8,1
1617,15904,99685,8,9,1
1617,15904,112641,7,10,3
1617,20713,83922,8,7,1
1617,2461,98724,5,10,5
1621,19535,102536,9,8,1
1621,24111,108052,9,10,1
1621,12619,92593,9,10,1
1621,36058,106226,8,2,6
1624,32866,99685,8,10,2
1624,34477,104691,8,8,0
1624,30337,100502,7,4,3
1634,10103,99487,9,9,0
1646,6579,111161,9,8,1
1684,21728,104652,8,8,0
1684,35469,108211,8,7,1
1763,6643,113277,8,9,1
1763,8643,111161,10,9,1
1790,26632,111161,9,10,1
1790,25779,110912,6,10,4
1790,24434,112573,10,8,2
1790,17801,110478,7,8,1
1796,14185,109830,8,8,0
1796,35500,99487,8,10,2
1805,53,110912,10,10,0
1805,31617,108052,8,10,2
1805,34880,109445,6,8,2
1817,29291,107290,9,8,1
1817,7103,99077,6,9,3
1871,33117,105236,10,9,1
1871,9995,105323,10,9,1
1884,5933,63522,8,7,1
1888,33653,99685,10,9,1
1888,33653,108052,10,9,1
1888,9178,109830,10,8,2
1895,29224,86034,7,7,0
1895,29224,90264,7,8,1
1895,25426,86006,6,5,1
1895,26540,88763,8,10,2
1895,26540,96874,7,10,3
1895,29189,93870,7,10,3
1895,10579,110357,9,9,0
1895,10807,110989,6,2,4
1899,11009,106519,9,9,0
1916,6193,103639,9,8,1
1916,9495,110357,10,7,3
1916,17332,98554,7,6,1
1916,6579,112697,8,6,2
1916,35468,101414,10,7,3
1916,9283,98621,6,6,0
1947,29224,71807,8,7,1
1947,29224,76752,7,7,0
1947,29224,79574,7,6,1
1947,29224,82398,8,6,2
1947,33670,99785,8,8,0
1947,33670,104431,8,7,1
1950,33792,104348,7,7,0
1950,27114,106308,6,7,1
1950,10018,112818,7,8,1
1950,19446,96256,6,8,2
1950,29782,85244,5,5,0
1950,29782,93818,6,5,1
1950,16806,110005,6,9,3
1950,5195,113409,7,8,1
1950,27909,107507,7,7,0
2020,7790,108550,7,8,1
2029,21504,106489,9,9,0
2029,4316,112579,9,6,3
2029,34880,95497,8,7,1
2030,28541,97216,8,8,0
2030,28541,102526,8,6,2
2030,1916,97757,8,10,2
2032,27817,85694,9,9,0
2032,27817,90655,7,7,0
2109,11009,94964,10,9,1
2120,124,110912,6,4,2
2120,9925,112471,9,6,3
2168,9918,108052,10,9,1
2176,16716,91763,8,9,1
2176,23563,107554,8,8,0
2176,18705,93692,6,6,0
2176,23310,97770,6,7,1
2205,2867,86879,10,10,0
2207,4814,108052,8,10,2
2207,11510,105226,8,6,2
2224,29432,110912,9,8,1
2235,33095,51459,10,9,1
2235,33095,86879,10,10,0
2283,14524,81505,10,10,0
2309,18666,113409,4,8,4
2309,13394,105695,9,9,0
2309,2842,108550,7,7,0
2309,14228,110632,6,10,4
2309,1241,104036,7,9,2
2319,3758,95953,7,9,2
2319,13376,103874,8,8,0
2326,33752,106977,9,7,2
2326,6360,111686,6,8,2
2326,35176,95776,8,10,2
2326,10729,96794,7,6,1
2333,32172,110912,8,8,0
2333,11438,109830,9,9,0
2333,11936,112697,7,8,1
2333,33618,101889,6,8,2
2337,13394,107207,8,10,2
2337,2120,112471,5,9,4
2337,18575,113247,6,7,1
2337,9254,107048,8,9,1
2342,14447,78788,8,9,1
2342,9455,78935,7,7,0
2342,10579,102975,7,8,1
2345,28612,109520,6,5,1
2345,20901,112819,7,6,1
2347,1115,104409,6,6,0
2347,32771,109686,5,10,5
2347,32771,112442,6,10,4
2347,4023,96928,5,7,2
2376,17800,93779,10,8,2
2376,32378,89853,10,6,4
2376,3543,109424,10,5,5
2397,31613,66011,7,7,0
2401,19950,103759,7,7,0
2401,19950,112471,9,9,0
2401,4242,108160,8,8,0
2401,20446,104036,7,10,3
2421,17310,113277,10,8,2
2434,1234,112471,7,10,3
2439,18881,111161,10,10,0
2439,33457,110413,10,9,1
2458,16323,105236,9,6,3
2458,36074,102926,10,10,0
2458,14157,110912,10,8,2
2458,31275,99582,8,9,1
2461,28968,103064,10,10,0
2461,28968,113277,10,9,1
2461,25964,97576,10,9,1
2461,20929,99674,10,7,3
2461,20929,110912,10,10,0
2461,4667,105112,10,4,6
2461,11009,113161,8,9,1
2461,35591,98724,10,7,3
2485,27888,85959,8,7,1
2496,14755,90849,3,5,2
2496,8050,108394,9,8,1
2496,3943,111495,10,8,2
2496,3943,111507,8,8,0
2534,25404,113409,8,7,1
2547,27883,112471,8,9,1
2547,3430,112642,6,7,1
2547,32741,112573,8,8,0
2547,18696,109254,5,6,1
2547,5507,112691,8,8,0
2547,20901,108238,6,6,0
2547,20901,112461,7,8,1
2547,17301,112883,7,10,3
2574,28709,101889,7,7,0
2574,27307,110322,7,9,2
2574,34565,113247,9,10,1
2574,7240,102138,8,8,0
2574,3762,106677,8,7,1
2577,25404,79522,8,9,1
2577,10839,82085,7,8,1
2577,16806,109424,8,8,0
2577,32570,110057,10,9,1
2578,10440,110912,7,9,2
2578,25071,99423,6,8,2
2578,25071,105698,7,5,2
2578,25071,112864,7,8,1
2578,23647,96933,7,7,0
2578,11009,95016,8,10,2
2578,11009,113451,5,4,1
2578,34429,105236,8,7,1
2578,34429,113101,4,5,1
2578,4246,110308,6,7,1
2578,9307,95863,7,6,1
2578,9307,110823,6,6,0
2578,6623,102293,6,7,1
2603,1449,103874,10,5,5
2609,6168,64115,8,9,1
2610,18102,90605,8,8,0
2610,3988,84787,8,6,2
2623,9490,92890,7,9,2
2623,27045,99892,3,5,2
2623,35574,91042,5,8,3
2623,35574,94012,8,8,0
2634,11364,105323,9,9,0
2634,25071,112864,7,8,1
2634,14133,105695,8,7,1
2634,27580,110413,8,9,1
2634,30449,106977,7,8,1
2634,12730,112461,3,8,5
2634,4667,106856,6,7,1
2634,12220,104952,9,7,2
2635,20561,99685,8,9,1
2657,11631,99685,10,9,1
2657,26352,112641,9,9,0
2657,24545,101540,8,7,1
2657,11510,106226,7,6,1
2657,28909,102685,10,7,3
2677,11443,110912,8,10,2
2677,11455,111161,10,10,0
2677,11455,113277,10,8,2
2677,28395,112641,9,10,1
2677,23645,111257,8,7,1
2680,23021,110413,8,9,1
2680,36058,110729,7,6,1
2680,32423,108358,7,10,3
2680,27045,110005,8,7,1
2680,19033,110632,9,9,0
2684,28488,113277,10,8,2
2684,21364,112462,10,5,5
2684,18022,112641,10,10,0
2684,35792,109686,10,10,0
2684,3047,112281,10,8,2
2684,12292,110475,10,7,3
2684,1183,109506,7,10,3
2704,33794,99088,8,9,1
2712,13648,109836,4,8,4
2716,25085,111149,7,7,0
2716,5675,109831,10,6,4
2731,1488,107207,7,10,3
2731,1488,113277,7,9,2
2731,16556,107818,7,8,1
2731,16556,108550,7,8,1
2731,29064,109830,8,8,0
2731,21908,105236,6,7,1
2772,32598,101414,10,8,2
2772,27551,103639,10,8,2
2772,14604,102926,10,7,3
2772,35176,113497,7,10,3
2772,14417,107614,9,10,1
2772,21939,107120,8,10,2
2772,17801,101272,10,7,3
2772,4358,106220,8,7,1
2774,12364,105695,9,8,1
2774,31613,70735,10,6,4
2774,25549,89853,9,8,1
2774,20446,67411,6,9,3
2774,7103,107808,7,8,1
2775,31023,102975,10,8,2
2775,4973,110912,1,10,9
2779,22464,104431,10,8,2
2779,10579,107688,9,10,1
2783,33015,81398,8,8,0
2788,437,110413,9,9,0
2788,10161,110912,9,9,0
2788,20546,88247,8,10,2
2799,30165,64757,8,8,0
2799,10579,107206,7,8,1
2799,20713,95631,7,8,1
2816,7108,112384,9,10,1
2816,35276,103644,7,6,1
2816,36091,108071,9,10,1
2827,4605,112740,7,8,1
2827,8652,112819,7,7,0
2827,15834,106489,8,7,1
2827,18761,112864,8,8,0
2827,1763,106856,8,8,0
2827,19478,112442,8,8,0
2839,2841,111161,7,10,3
2839,32148,109830,7,10,3
2839,30968,104952,8,8,0
2839,6628,104797,7,10,3
2839,2842,110322,2,9,7
2842,33923,113247,7,9,2
2842,25102,108052,9,9,0
2842,9650,107207,9,10,1
2842,13394,110322,9,10,1
2842,13394,112573,10,10,0
2842,28914,105236,7,10,3
2842,36058,112471,8,8,0
2842,12220,108394,7,6,1
2842,3909,108550,7,8,1
2867,17963,99674,8,2,6
2867,17963,110912,10,5,5
2867,25964,97576,9,9,0
2867,14157,97814,9,6,3
2867,855,105236,9,9,0
2867,7412,100507,10,4,6
2867,29035,97757,9,10,1
2867,10514,106308,9,9,0
2867,4667,94862,9,7,2
2867,25404,99871,10,8,2
2867,25404,100814,9,5,4
2867,13376,93220,5,7,2
2867,13376,97474,6,7,1
2867,13376,97493,9,8,1
2867,13376,97527,7,10,3
2867,13376,101272,9,7,2
2867,13376,103874,5,8,3
2867,34849,104431,8,6,2
2867,34849,109415,6,2,4
2867,17801,103639,10,9,1
2867,17801,107614,9,9,0
2867,19446,107076,8,7,1
2867,13121,99611,8,9,1
2867,20145,92067,10,7,3
2867,26712,98213,9,7,2
2867,9797,99385,4,7,3
2867,28146,98503,7,6,1
2867,3543,111127,9,5,4
2870,20215,92005,8,8,0
2870,7771,108399,5,8,3
2870,32597,98724,8,7,1
2870,32597,100935,8,8,0
2870,32597,108122,9,8,1
2870,23015,97216,8,9,1
2870,11841,107048,7,5,2
2870,13723,89114,6,4,2
2870,8050,103874,7,7,0
2870,11009,110365,5,8,3
2870,32570,105151,5,8,3
2927,28050,112864,9,9,0
2927,14436,104257,9,8,1
2927,20546,100802,8,10,2
2927,13648,109836,7,8,1
2940,4740,106308,9,7,2
3047,191,111161,9,9,0
3047,1486,99674,7,8,1
3047,2684,112281,8,10,2
3084,2776,97958,10,9,1
3084,21278,94898,10,7,3
3120,19262,110413,9,8,1
3123,22685,107207,10,10,0
3123,16282,103074,8,8,0
3133,12786,112471,9,10,1
3133,7292,95765,10,8,2
3133,2684,78718,8,10,2
3179,26902,94862,5,7,2
3187,26902,103776,7,10,3
3187,26902,104431,9,7,2
3187,26902,110148,8,8,0
3187,13793,111503,8,8,0
3187,13793,113253,7,5,2
3187,10579,107977,7,10,3
3187,10579,109686,9,10,1
3187,10579,110475,8,7,1
3187,10579,110622,7,7,0
3187,13376,106977,8,8,0
3187,13376,109445,8,10,2
3187,13376,111282,7,8,1
3187,16485,107048,8,4,4
3187,25486,108308,7,6,1
3187,1441,107120,8,9,1
3187,34849,107362,6,6,0
3187,34849,109068,7,6,1
3187,4246,106770,7,6,1
3187,19182,112896,7,5,2
3187,11543,112817,7,10,3
3197,7029,108052,10,9,1
3197,27743,103939,9,8,1
3197,17667,96874,8,7,1
3222,25058,112471,10,8,2
3222,25964,97576,9,9,0
3225,34880,96283,7,8,1
3225,8050,91064,8,8,0
3247,20446,69762,10,8,2
3269,7626,84787,9,6,3
3269,17814,90756,5,8,3
3269,6579,103241,6,8,2
3269,11009,93777,7,6,1
3284,16556,105695,10,8,2
3292,32010,103064,9,8,1
3292,32010,106697,8,3,5
3292,32010,112281,7,8,1
3292,13376,104291,9,6,3
3292,13376,106582,7,10,3
3292,13376,111161,8,10,2
3292,17590,104714,10,9,1
3292,35176,110357,10,10,0
3292,35176,112864,9,7,2
3292,16282,105698,7,9,2
3292,16282,110475,8,7,1
3292,16282,110912,9,9,0
3292,30600,107290,10,9,1
3292,4667,112573,10,6,4
3292,10984,104070,7,7,0
3292,15124,104940,10,8,2
3292,25404,100814,7,5,2
3292,17801,110478,9,8,1
3292,26452,105812,8,9,1
3292,23215,103112,9,7,2
3292,7353,107501,8,6,2
3296,2816,103644,6,7,1
3296,35367,106977,7,8,1
3296,33095,107290,10,7,3
3296,17801,102945,8,8,0
3320,27648,97428,9,9,0
3320,4502,104868,9,7,2
3320,4502,109520,8,7,1
3320,4302,108037,6,8,2
3320,16282,110364,6,9,3
3320,26902,109506,10,10,0
3337,27524,99685,9,9,0
3337,25658,108052,10,9,1
3349,6740,95953,8,10,2
3349,8566,113277,9,9,0
3367,4884,112471,9,8,1
3367,28138,102926,9,9,0
3367,25549,96969,8,7,1
3367,4023,107362,8,7,1
3367,17801,94226,9,8,1
3367,17801,99810,8,8,0
3367,28914,89881,8,9,1
3367,35932,94074,1,1,0
3367,8050,88846,6,9,3
3367,26675,109445,5,7,2
3367,16716,109836,8,7,1
3367,17800,91474,2,7,5
3367,34303,106770,7,7,0
3367,11009,94663,6,7,1
3372,18529,106489,7,8,1
3372,29440,109707,8,8,0
3372,4573,101540,8,10,2
3372,15163,99077,8,9,1
3430,7113,111161,8,10,2
3430,2547,112642,7,6,1
3440,13648,99685,10,8,2
3461,2439,111161,10,10,0
3461,10808,113277,7,8,1
3461,27409,97165,8,8,0
3461,9005,99674,7,1,6
3461,8951,107822,9,6,3
3496,19372,109830,10,10,0
3524,34004,108394,10,7,3
3524,17800,93779,10,8,2
3524,21082,96283,10,8,2
3543,18052,110413,9,7,2
3543,7273,100405,7,9,2
3543,33390,107818,6,8,2
3543,19351,109424,5,9,4
3543,22900,110478,7,9,2
3543,2867,111127,5,9,4
3544,2487,111161,10,10,0
3544,21921,108052,9,10,1
3544,22685,107207,9,10,1
3570,3292,106582,6,7,1
3580,23913,112864,6,10,4
3580,13376,105104,5,8,3
3614,32597,57345,8,9,1
3614,1241,90756,8,9,1
3617,11510,106677,6,9,3
3617,11009,99871,8,8,0
3620,31977,107818,6,8,2
3620,28914,113277,8,8,0
3620,35477,112740,8,7,1
3632,7113,111161,10,10,0
3632,2940,106308,10,9,1
3632,3925,113627,8,7,1
3632,15251,110167,10,6,4
3632,27677,112697,10,7,3
3632,16214,107688,10,9,1
3632,20446,106881,10,8,2
3640,20901,104427,7,7,0
3640,13376,113277,7,9,2
3646,6380,110413,7,9,2
3646,35367,109830,9,10,1
3647,21718,111161,5,9,4
3647,1888,109830,8,10,2
3647,18022,112573,8,10,2
3647,18022,112641,9,10,1
3647,8282,110357,7,9,2
3647,1045,110622,10,7,3
3647,2684,110475,9,10,1
3673,34849,93777,8,8,0
3673,3187,92675,7,7,0
3673,26872,97659,7,7,0
3673,22090,99385,7,5,2
3673,27137,113409,6,7,1
3683,15394,81398,9,9,0
3688,10579,99487,10,8,2
3694,34849,93870,8,7,1
3724,17963,93870,9,6,3
3724,35792,85334,8,6,2
3724,30449,106977,9,8,1
3724,25404,90728,8,8,0
3724,33752,93105,8,6,2
3725,7851,108052,10,9,1
3725,31979,81398,8,9,1
3725,2337,82971,8,7,1
3725,33653,88763,9,8,1
3725,6628,87843,9,8,1
3725,18689,112864,9,9,0
3755,35935,105236,8,10,2
3758,18032,95953,9,7,2
3758,17814,102926,8,9,1
3758,33653,112573,7,8,1
3762,23588,99785,8,10,2
3762,23588,110322,8,10,2
3762,27534,105323,9,9,0
3762,2574,106677,7,8,1
3762,26769,93058,7,9,2
3802,25950,110912,9,9,0
3802,22594,100157,8,8,0
3802,35176,90633,8,10,2
3833,20106,60196,9,9,0
3844,35853,111161,10,10,0
3844,27751,110912,7,6,1
3844,27839,112864,8,8,0
3849,16623,94898,7,9,2
3849,13376,93300,2,2,0
3865,12903,89530,8,6,2
3866,17801,104389,6,8,2
3892,34397,112471,8,8,0
3892,19009,112384,6,7,1
3894,28952,96874,8,10,2
3903,16806,107808,7,8,1
3903,20446,108101,8,10,2
3905,34849,109445,8,10,2
3905,21883,109707,9,6,3
3905,15846,106226,5,7,2
3905,27817,107664,7,7,0
3909,18275,109830,10,10,0
3909,12292,108052,10,10,0
3909,13657,106519,8,7,1
3909,7292,112641,9,8,1
3909,17667,104573,8,7,1
3909,1998,108550,8,9,1
3909,23563,107554,9,8,1
3909,11009,104684,8,9,1
3917,20016,110413,10,8,2
3917,1790,112573,9,10,1
3917,26872,104797,6,10,4
3925,3632,113627,7,8,1
3943,8050,102494,7,7,0
3943,8050,108394,7,8,1
3943,3133,112471,8,9,1
3943,26902,106308,5,8,3
3943,11200,110428,7,7,0
3943,20106,99077,8,10,2
3943,9145,107614,6,8,2
3943,9178,107822,9,8,1
3943,13376,111149,7,9,2
3943,33991,113497,6,8,2
3943,20857,111495,8,10,2
3943,20857,111507,8,9,1
3943,12469,102687,5,3,2
3943,14498,100054,6,8,2
3943,17527,101765,8,5,3
3943,7706,93978,7,5,2
3943,6414,97136,2,7,5
3943,34303,106387,6,6,0
3943,19885,94315,8,9,1
3943,16806,94924,7,7,0
3943,35477,100998,8,9,1
3943,27137,92843,5,8,3
3953,17252,112573,10,10,0
3983,6727,97770,7,5,2
3983,18022,112573,9,10,1
3988,34854,88763,9,10,1
3988,34854,110912,9,9,0
3988,12645,109830,8,8,0
4005,2029,88846,10,9,1
4007,31674,107818,9,8,1
4007,2224,110912,10,9,1
4007,6891,103064,9,10,1
4007,26063,105236,8,8,0
4007,17415,110632,9,9,0
4012,30896,99077,10,9,1
4012,26808,104940,9,7,2
4012,26902,111257,8,8,0
4012,25404,83511,7,6,1
4016,20649,57012,10,9,1
4023,24259,113189,6,7,1
4023,3367,107362,7,8,1
4023,2347,96928,7,5,2
4023,10579,102510,8,8,0
4092,32560,107688,8,7,1
4092,1353,108052,9,10,1
4092,19182,112682,7,7,0
4095,19675,86637,10,9,1
4095,19675,89853,7,8,1
4095,32378,93818,8,6,2
4095,21037,91167,9,6,3
4095,27909,84329,6,7,1
4103,3372,99077,10,8,2
4103,3372,101540,9,8,1
4103,12860,112471,8,8,0
4105,34598,109830,10,10,0
4105,10926,111070,10,8,2
4112,26666,80861,7,8,1
4112,26049,81505,10,10,0
4112,15819,95953,9,9,0
4112,10263,95016,10,9,1
4112,10440,80761,9,6,3
4112,22953,83131,10,7,3
4112,22953,107048,9,8,1
4112,26872,106611,8,8,0
4112,34849,88128,9,9,0
4112,13376,83550,8,6,2
4117,735,111161,9,9,0
4117,2684,112281,8,10,2
4123,11081,95016,9,8,1
4123,4335,97216,9,10,1
4137,22471,105236,9,8,1
4137,4242,102926,10,9,1
4137,12220,107048,10,8,2
4141,4162,83658,7,10,3
4141,34429,100802,7,7,0
4162,191,111161,10,9,1
4162,1486,108052,9,10,1
4162,28312,110912,10,8,2
4163,21883,97441,9,10,1
4163,5675,92593,6,9,3
4185,35367,106977,8,8,0
4185,27184,113277,9,8,1
4188,18705,113277,9,8,1
4193,29224,79574,5,6,1
4193,29224,90264,7,8,1
4193,29224,113189,8,7,1
4242,4137,102926,9,10,1
4242,16623,108160,8,10,2
4242,13376,95990,2,7,5
4246,23563,105695,7,10,3
4246,27094,110527,8,6,2
4246,13793,95271,5,8,3
4246,20539,112401,6,7,1
4246,13376,96061,6,7,1
4246,13376,106856,6,8,2
4246,13376,107211,5,5,0
4246,13376,113492,5,8,3
4246,10094,103759,5,8,3
4246,32433,103772,7,7,0
4246,32433,109446,5,6,1
4246,12321,103776,8,8,0
4246,302,112740,7,9,2
4246,3187,106770,6,7,1
4246,20507,109635,6,5,1
4246,5507,93886,7,8,1
4246,6727,97770,6,5,1
4246,7311,99582,6,6,0
4246,10579,98141,5,8,3
4246,20446,110308,7,8,1
4246,26872,99739,6,8,2
4280,16157,99685,9,10,1
4281,28146,76723,8,8,0
4302,19185,107290,8,10,2
4302,5754,113277,8,8,0
4302,17801,104257,7,8,1
4302,17801,106918,7,8,1
4302,17801,112642,6,8,2
4302,32010,112442,8,9,1
4302,26902,105121,7,7,0
4302,13376,103956,5,6,1
4302,7103,108037,8,9,1
4305,7629,107207,10,9,1
4305,5754,113277,10,8,2
4305,23962,104431,7,6,1
4305,32180,107290,9,5,4
4305,32180,110475,7,4,3
4305,2684,105323,7,9,2
4305,35503,99077,8,9,1
4305,2839,104952,10,8,2
4315,11631,107290,10,8,2
4315,13061,107048,8,9,1
4315,18705,96061,7,6,1
4316,12364,94226,8,8,0
4316,17624,101393,7,7,0
4316,2029,112579,6,9,3
4335,35935,105236,10,10,0
4335,24818,110912,10,10,0
4335,10514,107688,10,9,1
4335,4667,102510,10,6,4
4335,4667,113277,10,9,1
4335,19581,112641,9,8,1
4335,1045,110622,10,7,3
4335,34880,100935,10,9,1
4350,133,93437,10,10,0
4358,23394,99674,8,9,1
4358,11009,106582,6,8,2
4358,2772,106220,7,8,1
4362,26374,107207,8,10,2
4362,20281,97937,8,10,2
4367,12268,95765,9,10,1
4367,7576,112471,8,7,1
4389,2283,81505,10,10,0
4389,35176,82406,9,10,1
4389,22075,107688,8,9,1
4434,22869,93870,8,9,1
4434,17801,100758,7,7,0
4470,20016,110413,9,8,1
4470,16969,112864,8,8,0
4472,34225,99685,10,8,2
4472,34225,105236,9,5,4
4472,8438,112573,10,10,0
4472,7071,97216,8,8,0
4494,17241,112573,10,10,0
4502,28050,104868,7,7,0
4502,28050,109520,7,6,1
4502,15124,107614,7,9,2
4502,15124,111070,8,7,1
4502,17801,109813,6,7,1
4502,35574,108308,5,2,3
4516,13043,107290,8,7,1
4516,4814,108550,7,10,3
4516,24277,107818,8,8,0
4516,11320,95953,7,10,3
4516,26872,105793,7,8,1
4518,11865,52311,9,9,0
4518,28791,53198,8,10,2
4529,15199,109830,9,9,0
4529,23390,111161,9,8,1
4529,31788,104797,9,10,1
4549,34849,91474,7,10,3
4549,13376,85549,8,8,0
4549,13376,86960,7,9,2
4549,3943,102494,8,7,1
4549,1950,110005,7,6,1
4549,11009,100944,8,8,0
4573,15381,102926,10,10,0
4573,7582,97388,3,6,3
4573,7582,107254,3,3,0
4573,22434,103919,10,9,1
4573,13793,101917,4,5,1
4573,35477,101540,10,9,1
4573,13376,97474,4,7,3
4605,21238,111161,10,10,0
4605,31674,112740,8,6,2
4605,18102,107076,6,4,2
4605,15968,113189,8,6,2
4622,4859,109445,7,7,0
4622,415,86637,9,9,0
4623,15440,110322,10,9,1
4623,27580,110413,10,9,1
4623,31519,108550,10,7,3
4655,23939,109424,9,3,6
4655,32853,109445,8,7,1
4655,6380,106519,5,8,3
4655,16282,104952,8,8,0
4655,6579,101921,9,8,1
4667,3844,110413,9,9,0
4667,3844,110912,10,7,3
4667,3844,111161,10,10,0
4667,3844,112864,9,8,1
4667,30239,108052,8,10,2
4667,30239,109830,9,10,1
4667,30239,112573,6,9,3
4667,26902,109506,10,10,0
4667,26902,111257,9,8,1
4667,26902,113277,9,10,1
4667,17801,106977,8,8,0
4667,17801,107818,8,8,0
4667,17801,108160,7,8,1
4667,17801,109040,4,7,3
4667,17801,109444,5,8,3
4667,17801,111503,9,6,3
4667,17801,112281,4,9,5
4667,13376,112722,5,6,1
4667,12903,108550,9,7,2
4667,12903,113627,7,8,1
4667,20294,108358,7,9,2
4667,34849,107362,2,6,4
4667,10579,111301,1,10,9
4667,25404,110632,1,8,7
4670,13801,112281,7,6,1
4681,10652,86979,9,8,1
4681,10729,84726,9,7,2
4682,16533,108052,10,10,0
4682,24930,107207,10,9,1
4682,2376,109424,8,10,2
4682,14674,113247,10,10,0
4698,11009,97958,9,7,2
4714,7462,87332,6,8,2
4714,25239,109506,6,10,4
4714,25521,106856,8,7,1
4714,15968,88930,9,8,1
4723,21728,80979,7,9,2
4723,12619,92593,8,10,2
4723,20937,73800,8,10,2
4723,20937,92651,8,7,1
4728,34954,97493,6,8,2
4728,20294,105793,6,2,4
4728,33618,112682,8,8,0
4740,10514,106308,7,9,2
4740,31613,110357,9,9,0
4740,13376,92890,7,8,1
4741,20106,112573,8,9,1
4752,3484,109830,8,8,0
4755,29291,111161,10,10,0
4755,11288,110912,8,4,4
4779,11009,94226,4,10,6
4808,9925,112471,7,6,1
4808,23510,113247,7,7,0
4808,27122,106226,4,10,6
4808,29029,108550,8,6,2
4808,22066,101410,8,9,1
4814,23645,108052,10,9,1
4814,35197,103064,10,7,3
4814,30148,108550,10,8,2
4816,2487,111161,10,10,0
4816,25404,107050,8,8,0
4831,23574,75314,8,10,2
4859,31625,100935,6,10,4
4859,33435,113247,8,8,0
4859,25599,109445,7,8,1
4859,1899,106519,8,9,1
4859,25917,101540,7,8,1
4859,13648,104691,7,8,1
4859,7790,108550,8,8,0
4859,30035,98084,4,6,2
4859,18077,104684,7,9,2
4871,24406,112471,8,10,2
4871,13376,103074,7,7,0
4875,16716,110148,6,5,1
4879,10734,111161,1,9,8
4884,28914,70735,8,8,0
4884,28914,71315,8,7,1
4884,28914,73195,7,7,0
4884,28914,77416,8,7,1
4884,28914,78748,7,8,1
4884,28914,95765,9,8,1
4884,8050,112384,6,8,2
4884,28698,113247,7,7,0
4884,25514,112471,8,9,1
4884,34565,95327,7,8,1
4884,17800,108399,7,7,0
4884,36058,101540,7,8,1
4884,27909,91167,8,9,1
4884,29158,95159,7,8,1
4884,8760,106489,8,8,0
4884,33254,78841,7,8,1
4889,18878,110413,8,9,1
4889,16015,104652,7,7,0
4889,21082,96283,8,8,0
4889,12652,97637,6,7,1
4889,2680,110729,8,7,1
4897,8760,106489,8,8,0
4922,8232,95016,9,10,1
4922,8232,111161,9,10,1
4973,32905,111280,7,6,1
4973,2775,110912,10,1,9
4973,27839,112864,7,8,1
4973,29976,105698,7,8,1
4973,17751,109686,7,10,3
4973,6891,112573,10,10,0
4973,29760,106697,8,8,0
4973,28621,110475,9,7,2
4973,35574,109040,10,7,3
4973,35574,112281,6,8,2
4973,31807,106582,7,9,2
4973,29086,110216,5,10,5
4973,31157,107076,6,8,2
4973,30558,109890,6,7,1
4973,11009,104779,8,7,1
4973,34429,113101,10,5,5
4973,16250,112401,7,8,1
4973,15251,109456,6,5,1
4973,31358,105477,6,2,4
4974,36106,113247,8,7,1
4989,17141,104714,8,6,2
4989,4605,111161,9,10,1
5101,28050,103776,8,8,0
5101,28050,112462,7,4,3
5101,32866,99685,10,10,0
5109,13544,100150,8,8,0
5109,4007,110632,8,9,1
5109,14553,101410,9,8,1
5109,10703,111257,9,8,1
5109,8050,110074,7,7,0
5109,11009,106677,8,9,1
5109,22090,98439,8,5,3
5110,29086,113277,10,10,0
5110,5655,107614,10,10,0
5114,27909,72684,10,10,0
5126,31519,108550,9,7,2
5132,6595,100157,8,8,0
5132,9283,110950,7,6,1
5137,27137,95765,10,5,5
5137,32570,112817,9,7,2
5195,19493,113409,8,8,0
5195,10802,77474,8,8,0
5195,34849,99528,8,7,1
5195,11009,83190,8,9,1
5204,14439,111161,10,10,0
5228,12786,112471,9,10,1
5257,28871,97239,10,6,4
5257,13284,99785,9,8,1
5257,11009,92699,10,7,3
5257,11009,106226,10,9,1
5257,9283,108160,9,10,1
5257,20713,95631,9,8,1
5257,35477,97123,10,8,2
5257,34849,96463,9,6,3
5269,7103,93748,6,10,4
5282,20195,102719,8,5,3
5282,12587,111686,4,4,0
5282,13793,110978,2,3,1
5285,19262,95705,5,9,4
5287,9236,110912,9,9,0
5287,24111,83987,8,7,1
5287,13394,82971,8,8,0
5287,13795,97441,8,9,1
5287,26996,78754,9,9,0
5287,23962,97123,7,7,0
5291,20430,81398,10,8,2
5291,6905,97216,8,10,2
5298,14295,109830,9,10,1
5350,2337,82971,7,7,0
5352,20160,108358,7,10,3
5352,28333,111161,9,10,1
5352,18455,113247,8,7,1
5352,14157,104691,5,8,3
5360,3292,92099,7,9,2
5399,22953,113277,9,10,1
5399,27534,111070,5,8,3
5416,2867,52357,8,8,0
5416,3187,99763,7,7,0
5423,16079,93870,8,7,1
5482,8069,112462,4,6,2
5482,18634,99871,9,10,1
5482,23533,103776,7,7,0
5482,13376,97474,4,7,3
5482,13376,113253,5,6,1
5482,10623,105793,9,9,0
5482,17801,97523,7,8,1
5483,21150,113277,9,5,4
5483,21610,110413,10,9,1
5486,11443,105695,9,9,0
5486,34225,107688,10,6,4
5486,6130,100802,7,10,3
5486,6130,106856,7,10,3
5486,7108,106977,6,9,3
5486,29976,105698,7,8,1
5486,30035,98084,7,6,1
5486,28160,104652,7,9,2
5495,29098,64757,7,7,0
5495,29098,66995,8,8,0
5500,4667,92991,10,7,3
5507,13648,97366,6,5,1
5507,13648,102059,7,8,1
5507,13648,107144,7,7,0
5507,26902,106364,8,9,1
5507,29204,100212,6,8,2
5507,2547,104361,8,8,0
5507,2547,112691,8,8,0
5507,10579,108255,2,8,6
5507,16282,100405,6,8,2
5507,7790,112896,5,6,1
5507,32183,112950,5,7,2
5510,32597,100935,8,8,0
5528,20215,97165,7,8,1
5528,853,107207,8,10,2
5528,29062,107822,9,10,1
5528,26893,97239,8,9,1
5528,11856,93105,7,9,2
5528,22900,97904,7,10,3
5528,17527,89755,7,9,2
5528,35734,98635,7,8,1
5534,24545,91042,10,7,3
5534,24545,95327,9,10,1
5534,7576,112641,10,8,2
5534,12220,95765,10,9,1
5534,12220,96283,9,6,3
5534,17667,87332,7,7,0
5534,28968,104348,10,8,2
5534,20084,94625,10,8,2
5534,6332,90967,7,9,2
5534,13572,88680,10,9,1
5534,21883,95159,3,9,6
5534,12903,87175,6,7,1
5534,6767,97889,7,8,1
5567,10835,112471,8,8,0
5567,1411,103064,9,9,0
5567,16485,107290,9,9,0
5567,17751,109686,8,10,2
5567,1790,99785,7,8,1
5567,22368,103639,8,8,0
5567,21370,113189,7,7,0
5597,26049,99685,10,8,2
5598,24511,75686,7,8,1
5598,24511,98635,8,8,0
5598,23678,95953,7,9,2
5598,18674,108160,5,10,5
5598,18674,110099,6,10,4
5655,18916,107808,9,9,0
5655,12928,93640,7,8,1
5655,23423,105690,7,5,2
5655,35550,95174,7,3,4
5655,7784,72926,8,7,1
5655,957,99951,7,6,1
5655,2867,107614,10,9,1
5655,20446,74991,8,9,1
5658,11009,96969,10,10,0
5670,29516,63759,6,7,1
5670,21728,80979,10,9,1
5670,21728,87544,10,8,2
5670,32597,74811,8,8,0
5670,19127,103767,9,10,1
5670,30907,110008,9,6,3
5675,15141,97937,9,9,0
5675,28914,95765,9,8,1
5675,3620,100157,7,7,0
5675,19194,97441,7,9,2
5675,13026,99077,8,9,1
5675,10495,102138,9,10,1
5675,24991,101410,7,7,0
5675,2716,109831,6,10,4
5675,19240,111495,7,9,2
5698,18987,107120,8,10,2
5698,8999,107614,7,6,1
5698,15525,110912,8,6,2
5703,19562,102926,9,8,1
5703,17844,107048,8,7,1
5703,17844,109830,10,9,1
5709,10054,109830,9,10,1
5709,15660,97814,8,9,1
5709,28450,104952,8,8,0
5709,25735,98645,8,6,2
5737,26872,109287,4,7,3
5754,20098,113277,8,9,1
5801,18098,93870,7,8,1
5801,29760,110413,10,9,1
5846,20779,111161,10,10,0
5846,18878,105236,9,6,3
5846,853,107207,10,10,0
5882,3367,112471,8,9,1
5919,21629,106489,10,7,3
5919,10495,102138,8,10,2
5919,10839,112442,7,8,1
5919,8050,102015,9,8,1
5919,34849,99939,7,8,1
5919,9797,109035,5,8,3
5919,20901,107889,7,7,0
5923,221,99674,7,8,1
5925,22028,110413,7,9,2
5931,18596,97474,6,8,2
5931,31305,113253,7,7,0
5931,14498,99810,7,7,0
5931,33402,110678,8,1,7
5933,13793,112471,8,8,0
5933,3348,88847,8,7,1
5933,23678,84707,7,8,1
5933,22848,99052,7,4,3
5933,7790,91859,7,7,0
5935,4193,90264,7,7,0
5935,29189,93428,5,10,5
5963,28050,110912,10,8,2
5965,15085,71853,8,6,2
5967,10839,84516,6,8,2
5967,1355,75314,9,9,0
5967,13376,91209,6,7,1
5967,13648,96163,7,5,2
5971,10054,109830,10,10,0
5971,13479,106677,7,9,2
5971,24545,99077,10,8,2
5991,2677,112641,9,9,0
5991,17969,95953,9,9,0
6009,16323,97576,9,8,1
6013,27392,93058,6,7,1
6013,9178,86879,8,9,1
6013,27338,53604,8,9,1
6038,31396,76786,8,7,1
6058,1888,109830,7,10,3
6058,33653,112573,7,8,1
6066,22400,75686,10,8,2
6067,27909,109688,8,9,1
6122,22862,110357,8,8,0
6130,12645,100802,10,8,2
6130,5486,106856,10,7,3
6130,34429,103074,10,8,2
6138,27395,107290,8,7,1
6138,35469,109831,10,8,2
6150,1411,103064,7,9,2
6150,11599,103644,6,6,0
6152,15394,70666,7,7,0
6152,33618,103994,7,7,0
6155,17298,102926,10,10,0
6155,32532,105236,10,9,1
6155,3187,110475,8,8,0
6155,20688,113497,7,7,0
6155,16250,112462,6,7,1
6155,26902,113118,7,10,3
6168,8512,103644,8,7,1
6168,30905,111280,10,5,5
6168,4007,90728,9,8,1
6168,17801,89927,8,9,1
6168,35164,89175,10,7,3
6168,17704,100507,6,2,4
6168,21883,107666,8,8,0
6168,13376,90329,10,7,3
6168,4023,88170,10,6,4
6168,36016,102744,7,9,2
6175,31849,107048,7,9,2
6175,27909,93822,7,7,0
6184,11942,111161,10,10,0
6193,31396,112471,8,7,1
6193,19262,110413,10,8,2
6253,26643,97958,9,8,1
6265,191,110413,10,7,3
6269,13657,105323,8,8,0
6269,17241,107207,8,9,1
6273,17527,64116,9,9,0
6273,11009,68699,8,8,0
6289,13657,106519,9,7,2
6289,24870,112641,9,8,1
6308,17667,97351,8,9,1
6325,18984,111161,10,9,1
6325,19009,93058,8,8,0
6325,695,99785,9,10,1
6332,19127,107653,8,9,1
6332,8050,94888,7,7,0
6360,2326,111686,8,6,2
6360,13376,111257,10,8,2
6360,21883,110997,9,9,0
6376,10774,111161,10,9,1
6380,33640,112818,8,8,0
6380,3646,110413,9,7,2
6380,2534,111161,9,10,1
6380,13059,110322,7,10,3
6380,13376,112722,7,6,1
6394,31807,103064,10,10,0
6401,1010,93191,10,9,1
6411,1813,108052,6,10,4
6414,3187,95271,8,7,1
6414,3187,97474,6,6,0
6414,3187,97815,10,9,1
6414,3187,97958,10,9,1
6414,3187,99763,10,7,3
6414,3187,107048,9,8,1
6414,3187,113253,5,7,2
6414,34849,94012,10,8,2
6414,442,103873,9,10,1
6414,13376,94890,5,5,0
6414,13376,105690,8,8,0
6414,31807,93560,8,10,2
6414,31807,113375,9,9,0
6414,19892,98627,9,6,3
6414,10579,94602,7,7,0
6414,11009,107286,7,8,1
6414,11009,113161,8,9,1
6414,26872,110442,9,6,3
6414,34880,97108,8,6,2
6414,27817,93624,9,9,0
6414,27817,97136,7,5,2
6414,27817,102690,7,8,1
6414,27817,110667,8,10,2
6414,27045,96454,8,6,2
6427,12162,109830,10,9,1
6449,25514,112471,9,9,0
6456,30045,107290,9,8,1
6456,15904,112641,9,10,1
6511,21230,55601,10,10,0
6511,35556,60827,10,7,3
6511,32597,57012,10,8,2
6511,1134,69467,10,7,3
6511,20430,78788,10,9,1
6511,11009,68473,7,10,3
6579,31674,112740,6,6,0
6579,31674,113492,5,6,1
6579,17801,104257,8,8,0
6579,17801,104431,5,8,3
6579,17801,104694,6,9,3
6579,17801,105417,6,8,2
6579,17801,107206,6,8,2
6579,17801,108160,9,8,1
6579,17801,109444,6,8,2
6579,17801,109830,10,9,1
6579,17801,112462,6,7,1
6579,17801,112864,7,8,1
6579,32294,105236,9,9,0
6579,27648,111161,8,10,2
6579,13376,112442,5,6,1
6579,14498,105112,6,7,1
6579,26902,112697,6,9,3
6579,23533,107507,8,7,1
6579,20684,113161,8,6,2
6579,22856,113101,6,4,2
6579,18785,106611,5,9,4
6579,18785,108147,4,6,2
6579,26872,113041,5,8,3
6579,11599,104452,7,8,1
6579,33680,109951,7,8,1
6595,9878,95765,9,10,1
6595,33390,107818,9,8,1
6595,5132,100157,8,8,0
6595,23678,112818,10,8,2
6597,4859,89218,8,3,5
6597,3197,103939,7,9,2
6597,290,84868,8,8,0
6597,7946,89175,5,10,5
6598,13657,105323,10,8,2
6598,3465,107048,7,7,0
6598,14316,112641,8,7,1
6598,29058,113277,8,7,1
6598,2574,101889,6,7,1
6623,8780,107290,9,7,2
6623,3844,112864,7,8,1
6623,2779,104431,6,10,4
6623,2684,109686,7,10,3
6623,4667,102138,8,8,0
6623,4667,102803,7,4,3
6623,4667,106582,7,8,1
6623,13376,103919,7,7,0
6623,13376,105690,6,8,2
6623,10579,107206,7,8,1
6623,13793,104692,6,7,1
6623,2867,107076,7,8,1
6623,3187,100260,7,7,0
6623,2578,102293,7,6,1
6624,4573,70047,10,10,0
6624,1210,90756,4,8,4
6628,11019,108052,9,10,1
6628,9650,105323,9,10,1
6628,11443,105695,9,9,0
6628,31648,104797,10,9,1
6642,15896,104257,9,9,0
6642,15085,90329,8,8,0
6642,12220,96283,7,6,1
6653,5846,111161,10,10,0
6653,5126,92005,10,8,2
6653,8162,94737,9,8,1
6659,11510,99685,10,10,0
6659,11009,90180,7,8,1
6659,31613,87469,7,7,0
6659,31613,97576,8,6,2
6680,35734,112818,7,8,1
6680,35082,99785,8,8,0
6680,23801,100403,5,10,5
6680,13376,107211,5,5,0
6690,20684,100502,10,6,4
6690,17801,101272,10,7,3
6690,13376,107978,10,6,4
6712,654,96874,8,8,0
6712,9163,99088,8,7,1
6727,13236,96874,8,9,1
6727,3983,97770,5,7,2
6727,34854,112641,9,8,1
6727,19185,107048,8,7,1
6764,19250,84787,8,8,0
6764,17963,93870,7,6,1
6764,17963,100502,5,3,2
6764,30558,100802,7,4,3
6767,29224,71807,7,7,0
6767,29224,76752,10,7,3
6767,29224,79574,6,6,0
6767,29224,82398,7,6,1
6767,29224,90264,7,8,1
6767,25426,86006,6,5,1
6767,33670,78748,8,10,2
6767,33670,90605,10,10,0
6767,33670,103644,6,6,0
6767,32026,70488,7,7,0
6767,33398,93409,8,8,0
6767,33398,97733,8,8,0
6767,35574,87332,9,10,1
6767,19967,94291,7,8,1
6767,13492,104714,7,8,1
6767,6414,88933,8,7,1
6767,15360,97444,6,6,0
6767,19814,74751,6,6,0
6767,11009,91203,8,8,0
6789,1813,108052,10,10,0
6808,27677,112697,5,7,2
6808,25404,110148,7,8,1
6878,4472,99685,7,10,3
6878,7851,88247,9,6,3
6878,7851,103064,9,6,3
6878,23021,84787,7,7,0
6881,35222,110632,8,7,1
6881,10133,95327,10,7,3
6881,28160,91530,9,9,0
6884,4358,80678,10,9,1
6884,20281,97937,10,10,0
6884,34565,74958,10,7,3
6890,26808,107688,10,7,3
6891,12753,107290,10,10,0
6891,18052,112573,10,8,2
6905,26903,97216,10,8,2
6905,27526,88847,10,5,5
6905,30022,97165,8,7,1
6905,36058,111149,8,8,0
6925,36058,111149,7,8,1
6925,20713,95468,7,8,1
6927,25549,103939,7,6,1
6927,7946,106598,7,8,1
6927,14286,97958,8,9,1
6927,20901,100449,6,7,1
6927,11009,103035,7,5,2
6972,30329,99785,10,7,3
6989,16485,95016,7,7,0
6989,32433,54215,4,8,4
6989,7747,56592,7,9,2
7025,9435,107290,8,10,2
7025,29760,112740,8,8,0
7025,16250,109303,4,9,5
7025,26872,110657,3,7,4
7025,17801,103855,5,8,3
7025,7103,109446,7,7,0
7029,20760,111161,9,10,1
7029,20098,109830,9,6,3
7029,1763,110912,10,9,1
7029,18248,110413,9,8,1
7039,25071,105698,6,5,1
7039,16250,112401,5,8,3
7051,15360,93437,7,9,2
7054,11446,97958,10,10,0
7054,5507,89670,10,7,3
7054,30760,99685,10,9,1
7071,33653,93058,9,9,0
7071,8050,97216,8,9,1
7073,14592,100502,7,7,0
7073,13376,107978,4,6,2
7074,17800,108399,9,7,2
7076,29224,79574,6,6,0
7076,29224,82398,6,6,0
7076,29224,86034,7,7,0
7076,29224,90264,6,8,2
7076,35574,102685,7,8,1
7093,12220,95765,10,9,1
7093,12220,97165,8,7,1
7093,12220,99685,9,8,1
7093,12220,102926,9,10,1
7093,12220,105236,9,8,1
7093,12220,105695,10,10,0
7093,12220,108052,10,10,0
7093,12220,110413,8,8,0
7093,12220,110912,10,8,2
7093,12220,112471,9,8,1
7093,12220,112573,10,9,1
7093,12220,112641,10,9,1
7093,12220,113277,9,9,0
7103,15877,112818,8,7,1
7103,341,103064,10,8,2
7103,11009,96446,7,4,3
7103,11009,97216,7,8,1
7103,11009,97958,8,7,1
7103,11009,100150,8,8,0
7103,11009,102138,8,10,2
7103,11009,107048,10,8,2
7103,11009,108394,6,9,3
7103,11009,112384,7,9,2
7103,28914,112573,8,9,1
7103,31460,103644,8,7,1
7103,711,112471,8,9,1
7103,7108,96874,10,9,1
7103,7108,98273,7,7,0
7103,7108,99088,7,8,1
7103,7108,106856,8,8,0
7103,16250,97428,7,10,3
7103,19240,111495,8,9,1
7103,19240,111507,8,8,0
7103,13376,98554,8,7,1
7103,13376,101917,2,6,4
7103,13376,102798,6,7,1
7103,13376,105121,6,7,1
7103,13376,105435,8,7,1
7103,13376,106308,8,8,0
7103,13376,106697,7,7,0
7103,13376,109686,8,8,0
7103,13376,111257,7,8,1
7103,13376,111438,5,7,2
7103,13376,111686,7,7,0
7103,33752,99077,9,5,4
7103,14436,104257,8,8,0
7103,14436,108399,8,9,1
7103,26902,97981,3,5,2
7103,15648,113409,6,3,3
7103,23614,107209,7,7,0
7103,16716,98635,10,8,2
7103,13394,107808,8,8,0
7103,406,107822,9,9,0
7103,28700,113189,7,7,0
7103,4316,101393,6,7,1
7103,23215,109446,7,6,1
7103,36087,98258,9,8,1
7103,12306,108037,9,7,2
7103,30600,107798,6,6,0
7103,29582,101587,8,7,1
7108,19372,96874,9,9,0
7108,19372,99088,8,10,2
7108,19372,106977,9,9,0
7108,22471,111161,9,10,1
7108,31157,100802,8,8,0
7108,31157,112384,10,8,2
7108,32010,109506,7,8,1
7108,12770,107818,8,8,0
7108,7103,98273,7,7,0
7108,7103,106856,8,8,0
7108,9932,97647,7,7,0
7108,28968,107473,7,6,1
7108,13793,99994,5,6,1
7108,26643,113305,9,8,1
7183,9005,99674,8,1,7
7183,21718,99685,7,9,2
7198,1947,99785,7,8,1
7199,24511,112641,9,8,1
7203,8566,113277,9,9,0
7213,5352,93894,7,7,0
7213,31157,100802,8,8,0
7221,35797,106489,8,8,0
7240,28786,113277,8,9,1
7240,11888,110912,9,9,0
7273,35797,100405,9,7,2
7273,24434,108160,8,7,1
7275,11599,96895,4,10,6
7275,24760,109830,10,9,1
7275,10186,110912,9,9,0
7275,4529,111161,10,9,1
7275,4502,100758,5,8,3
7292,3909,108052,9,10,1
7292,3909,112641,8,9,1
7292,34225,99685,8,8,0
7292,34225,110413,8,10,2
7292,34225,111161,10,10,0
7292,14630,112573,9,10,1
7292,3133,95765,8,10,2
7292,16533,93058,9,9,0
7292,17667,107048,8,8,0
7292,336,99785,7,9,2
7292,555,103064,8,7,1
7292,6927,96283,8,7,1
7292,2030,97757,8,8,0
7292,4889,92067,8,8,0
7292,34880,95497,7,7,0
7311,24259,113497,9,7,2
7311,12220,106246,10,7,3
7311,13376,105690,9,8,1
7352,11510,99365,7,5,2
7352,11510,106308,7,6,1
7353,30013,98724,4,7,3
7353,16716,91763,7,9,2
7353,7093,93105,7,7,0
7353,24545,92965,7,9,2
7353,12102,113492,6,7,1
7353,27007,106489,7,8,1
7353,34849,113101,6,8,2
7353,9862,96257,5,8,3
7353,22981,93692,6,10,4
7353,27487,108002,8,7,1
7353,14498,111255,6,5,1
7353,4246,106856,7,6,1
7353,9283,110478,6,6,0
7353,3292,107501,6,8,2
7377,889,99700,10,7,3
7412,18275,111161,10,10,0
7412,22241,89927,10,10,0
7412,29035,100507,4,8,4
7412,32010,106697,6,3,3
7424,30035,77651,7,7,0
7456,23293,104694,8,9,1
7456,23293,112384,8,7,1
7456,11559,111257,7,8,1
7456,17801,108160,5,8,3
7461,25900,107818,10,7,3
7517,16616,105236,8,6,2
7517,5302,110912,9,10,1
7529,15251,99487,8,7,1
7529,15251,103776,3,7,4
7529,15251,112462,2,7,5
7529,808,109506,10,10,0
7529,35053,110950,6,8,2
7529,16250,100802,8,9,1
7529,16250,111503,6,10,4
7529,3292,106582,3,7,4
7529,6579,102803,10,5,5
7529,34849,106452,7,5,2
7549,15632,112384,6,7,1
7575,11330,105323,10,9,1
7576,9925,112471,7,6,1
7576,15529,110413,8,9,1
7576,31460,112641,8,10,2
7576,11066,110357,9,10,1
7576,21261,106677,7,8,1
7582,35312,107254,3,2,1
7582,13793,99994,7,6,1
7582,13793,110978,3,3,0
7582,36091,102057,8,8,0
7607,23839,112641,8,9,1
7607,27045,112508,6,4,2
7611,34413,100260,10,7,3
7611,21370,110413,9,8,1
7611,33752,101889,9,8,1
7611,13648,105327,8,8,0
7611,36058,104348,9,3,6
7611,35469,112288,8,6,2
7611,35477,113481,8,5,3
7626,26744,87332,8,9,1
7626,26872,105812,6,8,2
7629,11443,105695,9,9,0
7629,18736,107207,9,8,1
7640,2439,109830,10,10,0
7640,2439,110413,9,10,1
7640,11461,110912,7,10,3
7640,16556,107818,10,8,2
7640,17667,104573,6,7,1
7640,3187,109068,6,7,1
7646,5971,106677,8,7,1
7646,5483,113277,8,9,1
7646,19033,101507,8,9,1
7646,3632,91419,8,10,2
7655,6236,109830,8,10,2
7655,8643,111161,8,9,1
7679,32294,96895,8,9,1
7679,32294,103776,8,6,2
7687,13801,98439,8,6,2
7704,25472,112573,10,9,1
7704,6579,108160,9,9,0
7704,18077,82010,6,9,3
7704,22090,84805,5,7,2
7704,14139,84726,10,7,3
7704,13648,80120,10,8,2
7706,15904,108052,10,10,0
7706,15904,111161,10,10,0
7706,17078,113497,7,4,3
7706,17593,97428,7,10,3
7706,24572,105695,9,8,1
7706,20356,102138,8,8,0
7706,15877,112818,9,7,2
7706,19250,103919,3,6,3
7706,21883,106664,5,7,2
7706,13376,103074,8,7,1
7706,31942,109836,8,6,2
7706,15124,99740,4,3,1
7706,14755,103905,4,4,0
7707,11009,105265,7,9,2
7712,336,99785,7,9,2
7712,17801,112864,7,8,1
7718,31519,108550,8,7,1
7718,35844,111161,8,10,2
7718,12652,109686,8,9,1
7718,24672,112461,6,7,1
7731,13376,107034,10,6,4
7747,6989,56592,9,7,2
7771,31307,44837,10,10,0
7771,32597,95327,9,9,0
7784,17844,107048,9,7,2
7784,22900,110478,7,9,2
7784,17801,102798,7,8,1
7784,20446,74937,8,8,0
7790,1790,108550,8,7,1
7790,3620,113277,8,8,0
7790,26371,110413,9,9,0
7790,27077,112384,8,10,2
7790,21939,113419,6,10,4
7790,9932,113540,7,7,0
7790,24041,108333,5,6,1
7790,12591,112896,6,10,4
7790,6579,106611,6,5,1
7790,34849,111190,3,6,3
7790,26872,110364,6,8,2
7790,35176,113114,4,10,6
7790,2827,112819,6,7,1
7790,23966,110989,4,6,2
7790,8811,107302,6,6,0
7790,25325,112255,2,5,3
7790,20469,110123,3,5,2
7821,33653,81398,10,9,1
7821,26712,74958,8,8,0
7821,8050,86979,8,8,0
7848,11371,108052,10,10,0
7848,7576,110357,10,9,1
7851,11461,108052,9,10,1
7851,22400,109830,7,10,3
7851,13795,111161,7,10,3
7860,22090,110955,7,7,0
7860,7790,108333,7,5,2
7860,3187,106770,8,7,1
7868,19182,112682,8,7,1
7868,3187,107048,9,8,1
7906,6595,100157,8,8,0
7906,22869,87799,6,9,3
7906,10579,111070,5,8,3
7911,29291,107290,9,8,1
7911,6380,110322,4,7,3
7911,13394,107808,7,8,1
7946,34082,112471,10,9,1
7946,3187,109686,10,9,1
7946,3187,110475,10,8,2
7946,21883,110997,8,9,1
7946,6579,106611,10,5,5
7946,6927,106598,8,7,1
7950,28146,105665,8,8,0
7950,8050,100935,10,10,0
7956,24672,105236,8,9,1
7956,11445,94291,10,8,2
7967,34044,53125,8,9,1
7967,34044,58329,7,8,1
7967,17814,84787,5,8,3
7967,13394,70735,8,10,2
7967,10839,93870,7,8,1
7967,5486,68611,8,6,2
7967,27909,56119,8,10,2
7985,25472,112573,10,9,1
7985,25249,111161,7,10,3
7985,20145,109040,7,7,0
7985,20145,112281,7,7,0
7985,25404,112442,8,5,3
7985,33989,109117,9,8,1
8032,19507,109830,8,9,1
8032,26480,102926,9,9,0
8032,109,111161,9,10,1
8036,13376,99487,10,8,2
8038,3465,107048,9,7,2
8038,11707,94315,7,7,0
8038,19814,108122,8,9,1
8038,7529,96754,8,10,2
8043,17639,61184,10,6,4
8043,32597,93058,8,8,0
8050,4884,95765,8,9,1
8050,4884,112384,8,6,2
8050,28914,78788,10,8,2
8050,34565,79522,8,8,0
8050,34565,87884,10,10,0
8050,25549,83946,9,9,0
8050,25549,93191,8,9,1
8050,25549,100935,10,8,2
8050,25549,102494,7,7,0
8050,25549,103939,8,6,2
8050,25549,113627,8,8,0
8050,32597,86637,7,10,3
8050,32597,93822,8,8,0
8050,32597,102511,7,6,1
8050,32597,110074,7,8,1
8050,31613,94291,8,6,2
8050,12220,108394,8,6,2
8050,17527,88846,9,9,0
8050,8610,94336,8,8,0
8050,25404,97216,9,8,1
8050,27524,87800,6,8,2
8050,32183,92991,7,7,0
8050,11841,86979,8,6,2
8050,11009,81455,7,7,0
8050,11009,82340,7,8,1
8050,11009,91064,8,8,0
8050,11009,93870,8,9,1
8050,11009,94964,8,9,1
8050,11009,103776,7,5,2
8050,11009,103874,7,8,1
8050,11009,106977,8,9,1
8050,19127,81070,8,6,2
8050,19127,86216,9,7,2
8050,31598,102015,8,9,1
8050,21883,86567,7,10,3
8050,30648,104029,8,8,0
8050,9283,86197,8,8,0
8050,20446,79641,8,9,1
8050,20446,80319,6,8,2
8050,27045,77745,8,6,2
8050,6332,94888,7,7,0
8051,35550,103644,6,6,0
8069,5482,112462,6,4,2
8088,4879,111161,10,1,9
8088,19033,109445,7,8,1
8145,1365,60196,8,9,1
8145,32233,102926,9,9,0
8155,2635,99685,10,8,2
8155,3430,110912,10,8,2
8155,17510,110413,9,6,3
8155,15525,93389,8,8,0
8162,17078,110912,9,10,1
8162,31411,108399,10,9,1
8164,20713,102494,7,7,0
8194,845,107048,9,9,0
8194,29781,105236,10,7,3
8194,9236,99685,6,10,4
8226,31358,107290,8,9,1
8226,26808,86250,9,9,0
8232,10767,111161,10,9,1
8232,24085,112573,7,9,2
8232,32207,102926,9,10,1
8232,21240,110912,10,8,2
8232,2439,109830,9,10,1
8232,27314,95016,10,8,2
8256,25404,95327,10,7,3
8261,2176,81505,10,8,2
8261,31378,86190,6,8,2
8261,35794,91042,8,9,1
8261,29433,72684,9,8,1
8279,32313,93870,10,10,0
8279,4246,103759,10,5,5
8282,838,111161,9,9,0
8282,4494,112573,8,10,2
8348,17969,71562,10,9,1
8348,20700,72890,8,8,0
8348,11009,84855,3,9,6
8353,32010,92675,7,7,0
8357,221,99674,5,8,3
8357,18022,87843,5,7,2
8401,10652,105323,6,8,2
8401,5675,102138,9,9,0
8469,1888,50083,10,10,0
8488,1136,102803,7,8,1
8488,4302,96438,9,8,1
8488,4667,109506,9,10,1
8488,35176,101329,6,10,4
8495,31157,99810,9,9,0
8495,10729,92965,9,5,4
8512,25685,103644,7,5,2
8523,15784,105236,7,8,1
8523,15784,110912,9,8,1
8523,32207,102926,9,10,1
8523,22312,112641,8,10,2
8532,19310,112471,7,9,2
8566,34043,113277,9,10,1
8606,14305,109830,8,9,1
8606,28142,103767,9,7,2
8610,23510,113247,9,7,2
8610,22927,87843,9,7,2
8610,16716,94336,8,9,1
8623,221,99674,7,8,1
8623,11159,105323,8,10,2
8624,17415,102685,8,10,2
8624,5482,99871,7,9,2
8646,25465,53604,10,9,1
8652,2827,112819,7,7,0
8652,23563,109830,10,7,3
8659,3292,93058,10,10,0
8701,22643,93058,10,6,4
8701,20937,93191,9,8,1
8701,27909,78763,8,9,1
8701,19127,86216,10,7,3
8701,17527,101765,8,5,3
8701,10869,84707,8,9,1
8701,25658,71487,8,10,2
8723,6456,91149,8,7,1
8723,29582,103939,7,6,1
8723,6579,92099,7,6,1
8723,13376,106519,8,9,1
8733,2224,110912,9,9,0
8733,20274,105323,8,9,1
8743,5534,87332,7,7,0
8743,27909,74512,7,6,1
8760,23563,108052,7,10,3
8760,23563,109830,7,7,0
8760,23563,110357,7,10,3
8760,23563,110912,7,10,3
8760,33653,113277,7,9,2
8760,17667,112471,8,8,0
8760,28968,112641,7,8,1
8760,3844,112864,7,8,1
8760,2677,106519,6,9,3
8760,12292,105323,6,10,4
8760,12292,110475,7,7,0
8760,2684,109040,5,10,5
8760,2684,109686,4,10,6
8760,2684,112281,6,10,4
8760,14436,110148,6,8,2
8760,7221,106489,8,8,0
8760,25058,110322,7,8,1
8760,22990,110367,6,8,2
8780,12292,108052,9,10,1
8780,12292,109830,7,9,2
8780,12292,110413,8,10,2
8780,12292,110912,6,10,4
8780,12292,111161,10,10,0
8780,30591,112573,10,9,1
8796,3292,89218,10,10,0
8796,35574,60196,10,8,2
8811,1411,95016,8,8,0
8811,27444,112471,8,10,2
8811,19185,107048,8,7,1
8811,34565,107207,8,10,2
8811,7180,109707,5,9,4
8811,7103,98635,7,10,3
8811,16250,111503,8,10,2
8811,15124,111255,7,6,1
8811,7790,107302,6,6,0
8816,7103,98554,7,8,1
8864,20446,82736,8,10,2
8864,32183,92991,8,7,1
8864,3367,83907,6,7,1
8883,133,80684,6,10,4
8906,13376,89670,10,7,3
8920,17078,96438,8,10,2
8920,26330,102926,9,10,1
8920,18878,110413,8,9,1
8920,29163,106677,9,7,2
8944,11159,108052,10,10,0
8944,32207,102926,9,10,1
8944,17704,110955,9,7,2
8951,14730,110912,9,10,1
8951,23533,107822,6,9,3
8969,15706,110413,9,8,1
8969,2731,105236,5,6,1
8969,9862,100157,9,9,0
8978,11506,107818,7,10,3
8978,13739,107207,8,10,2
8979,35734,105812,10,8,2
8979,4667,108358,8,7,1
8983,19535,102536,9,8,1
8983,11009,102943,8,5,3
8985,25964,97576,10,9,1
8985,19372,106977,10,9,1
8985,28968,90329,10,8,2
8985,28968,104348,10,8,2
8985,28968,113277,10,9,1
8985,4667,87469,10,9,1
8985,4667,92644,10,2,8
8985,4667,105236,10,9,1
8985,7461,103074,10,9,1
8985,9790,103772,10,10,0
8999,27839,112864,8,8,0
8999,18052,112573,9,8,1
8999,9911,107614,6,7,1
8999,22848,103644,6,5,1
8999,31157,100802,8,8,0
9005,221,99674,1,8,7
9005,10767,73486,10,9,1
9006,12292,105323,8,10,2
9006,12292,108052,9,10,1
9006,12292,109830,9,9,0
9006,12292,110413,7,10,3
9006,12292,113277,9,8,1
9006,34225,107207,10,9,1
9006,23563,105695,8,10,2
9006,22312,106519,8,7,1
9018,26902,107290,9,10,1
9018,14286,106582,4,8,4
9018,10579,113492,6,6,0
9052,29976,89893,10,6,4
9052,13793,93437,10,10,0
9054,20344,110912,9,10,1
9054,20344,111161,10,9,1
9055,13801,58150,10,8,2
9055,29189,64757,6,10,4
9086,9236,105323,8,10,2
9086,6376,111161,8,10,2
9086,24111,79522,7,7,0
9120,20446,112637,3,9,6
9135,2772,113497,6,7,1
9145,26872,103639,10,10,0
9145,26872,110216,7,8,1
9145,26872,110357,10,10,0
9145,26872,110475,8,9,1
9145,26872,112442,8,8,0
9145,16749,102138,9,9,0
9145,16749,109303,7,8,1
9145,13801,113189,8,8,0
9145,16282,107614,8,8,0
9145,17801,100802,6,8,2
9145,17801,102057,9,9,0
9145,4112,105629,10,6,4
9145,35469,108211,8,7,1
9152,11432,96895,6,9,3
9152,7108,93894,4,7,3
9152,9283,110932,6,9,3
9178,29064,109830,8,8,0
9178,23678,107822,8,8,0
9183,10579,110357,9,9,0
9189,2458,110912,10,10,0
9189,7103,111495,8,8,0
9236,25950,110413,10,10,0
9236,25950,110912,9,9,0
9236,12666,113277,8,10,2
9236,19168,112471,9,8,1
9246,406,86250,8,9,1
9246,7529,93773,7,9,2
9246,11599,88247,9,9,0
9246,13533,77928,5,8,3
9246,21042,106519,8,9,1
9246,20700,93870,7,8,1
9246,963,71807,7,7,0
9246,17519,94074,4,3,1
9246,6884,74958,9,10,1
9246,34044,78841,8,10,2
9254,33421,103064,9,7,2
9254,21238,107048,9,8,1
9283,17801,102926,9,9,0
9283,17801,102945,6,8,2
9283,17801,103772,8,6,2
9283,17801,104257,7,8,1
9283,17801,104694,10,9,1
9283,17801,104714,1,8,7
9283,17801,106918,7,8,1
9283,17801,107290,3,9,6
9283,17801,107818,10,8,2
9283,17801,108052,10,7,3
9283,17801,108160,10,8,2
9283,17801,110478,6,8,2
9283,17801,110912,4,9,5
9283,17801,112384,8,9,1
9283,17801,112864,3,8,5
9283,27677,104231,1,6,5
9283,27677,109831,8,7,1
9283,27677,110322,9,8,1
9283,7029,106856,9,9,0
9283,23678,105323,5,9,4
9283,23678,107822,10,8,2
9283,23678,112573,1,10,9
9283,23678,112818,10,8,2
9283,14436,105265,10,9,1
9283,14436,110950,6,9,3
9283,16282,103074,10,8,2
9283,16282,104291,1,8,7
9283,12306,110932,9,8,1
9283,13648,105414,7,6,1
9283,20901,109635,7,7,0
9283,10293,107151,1,8,7
9283,20446,110428,6,10,4
9294,33752,107048,9,6,3
9294,33618,104348,9,9,0
9294,17527,93779,7,5,2
9307,1328,106677,7,6,1
9307,18335,97981,5,6,1
9307,30777,102685,8,8,0
9307,2578,95863,6,7,1
9307,2578,110823,6,6,0
9326,33254,79417,7,9,2
9387,9455,104070,3,8,5
9413,29224,93428,8,6,2
9413,29224,105236,10,8,2
9413,25426,107290,8,6,2
9413,25426,111282,9,7,2
9413,7718,108550,9,8,1
9413,7718,111161,10,8,2
9413,20493,113277,9,9,0
9413,10579,106856,9,8,1
9413,35574,94226,9,9,0
9413,22400,102926,10,9,1
9413,28914,93058,10,7,3
9413,28914,112573,8,9,1
9413,4246,93779,10,8,2
9413,20446,91474,10,9,1
9413,18077,94625,10,9,1
9413,1449,113568,9,9,0
9413,7353,111255,8,6,2
9413,15644,98206,8,9,1
9422,7103,112471,6,8,2
9435,4755,107290,10,9,1
9435,17801,106697,9,8,1
9444,5675,95765,10,9,1
9444,24629,105695,10,7,3
9455,18335,101917,7,6,1
9455,35522,110912,10,10,0
9455,32539,110632,9,7,2
9455,13793,103919,8,7,1
9455,4561,110148,9,8,1
9455,27453,110475,7,8,1
9455,10263,105236,9,9,0
9455,11599,104070,8,7,1
9455,11599,107302,8,7,1
9455,10579,104940,8,9,1
9455,6579,100405,6,5,1
9455,36058,101700,8,7,1
9455,20195,109045,8,8,0
9455,9283,102945,7,6,1
9467,2839,102926,8,8,0
9474,1089,88847,7,8,1
9474,5109,100150,8,8,0
9490,2458,93105,7,9,2
9490,18785,106611,8,9,1
9490,9797,92890,9,8,1
9495,12903,110357,7,10,3
9537,20515,110912,10,10,0
9537,4335,112641,10,9,1
9537,4335,113277,9,10,1
9537,15904,108052,10,10,0
9537,11102,109040,10,10,0
9537,10579,110364,10,8,2
9537,18116,110057,10,8,2
9537,24248,108037,10,7,3
9604,23892,109830,10,10,0
9604,20684,105793,9,8,1
9604,20684,108525,7,7,0
9650,11019,107207,10,8,2
9650,11019,109830,10,9,1
9650,11019,113277,10,8,2
9650,6628,105323,10,9,1
9650,20106,112641,10,10,0
9650,12220,102536,8,6,2
9658,19158,103639,8,8,0
9658,34225,99487,7,9,2
9658,16716,113161,6,6,0
9663,32010,93058,9,9,0
9663,28968,96969,7,8,1
9663,13376,105690,7,8,1
9667,24572,93058,8,8,0
9668,3292,111161,10,8,2
9679,15516,100758,8,10,2
9702,1796,109830,9,8,1
9702,3465,107048,8,7,1
9702,19374,111495,10,9,1
9702,19271,108394,10,9,1
9702,19271,111507,8,9,1
9702,33095,107943,8,8,0
9722,31741,113277,7,8,1
9741,33212,95016,8,9,1
9741,13376,80745,6,9,3
9741,13376,88323,7,8,1
9741,13376,91059,6,10,4
9741,628,77572,5,8,3
9741,9413,88024,6,8,2
9772,20062,73486,8,10,2
9772,7292,47396,7,8,1
9779,2842,112573,9,10,1
9779,34849,113101,10,8,2
9780,31830,105236,8,7,1
9780,34429,105265,8,7,1
9790,22455,109254,4,8,4
9790,20849,103772,10,5,5
9790,22856,101272,5,7,2
9790,12534,109707,9,10,1
9797,6009,97576,10,9,1
9797,1790,99785,10,8,2
9797,5352,102057,9,8,1
9797,10293,105414,7,7,0
9797,35477,101540,8,9,1
9797,2867,99385,7,4,3
9797,34849,100740,6,7,1
9808,27881,109445,5,9,4
9808,5933,88847,8,8,0
9825,28669,62229,10,10,0
9843,20688,109831,6,8,2
9843,20446,97322,5,8,3
9843,20446,105428,7,5,2
9862,23945,100157,9,5,4
9862,7353,96257,8,5,3
9883,2470,95631,9,7,2
9883,17747,84390,8,7,1
9883,17747,93342,8,8,0
9883,17747,98532,7,7,0
9883,28791,110917,8,8,0
9883,32597,84549,9,8,1
9883,8050,93191,9,8,1
9883,32570,105151,10,8,2
9883,11009,92699,8,7,1
9883,29047,91355,9,9,0
9883,28669,84335,9,10,1
9911,22796,103060,3,5,2
9911,21370,107614,7,7,0
9918,2168,108052,9,10,1
9918,35477,111282,7,7,0
9932,27839,112864,8,8,0
9932,1790,112573,8,10,2
9932,35176,112453,8,10,2
9932,35176,113497,8,10,2
9932,12652,110475,7,8,1
9932,7790,113540,7,7,0
9956,9650,86879,8,10,2
9976,40,102926,10,8,2
9976,24897,86567,8,8,0
9976,35468,112431,8,8,0
9982,20355,85407,10,7,3
9995,9006,105323,9,8,1
9995,9006,105695,8,8,0
9995,32648,74958,8,7,1
10001,16485,112573,10,9,1
10018,15729,112471,10,9,1
10018,35734,112818,8,8,0
10018,7029,106856,7,9,2
10018,11009,102943,1,5,4
10018,27534,110932,8,7,1
10018,8050,86197,8,8,0
10018,2401,76723,6,7,1
10018,33878,76363,3,8,5
10018,17801,99422,3,8,5
10018,17801,101587,5,8,3
10018,17801,103855,6,8,2
10018,20901,109635,6,7,1
10018,7103,74512,4,7,3
10018,20446,106881,9,8,1
10025,3781,110989,7,8,1
10025,21370,110475,8,7,1
10042,28182,80319,8,6,2
10042,22090,102511,7,7,0
10042,22628,87182,5,5,0
10042,30907,95776,6,3,3
10042,13492,103241,7,8,1
10042,17527,85959,8,9,1
10042,31096,77288,8,4,4
10042,11009,96764,7,8,1
10046,10729,110932,10,5,5
10054,7113,111161,10,10,0
10077,7686,90605,10,8,2
10077,11599,96895,8,10,2
10084,25465,70666,7,7,0
10103,34225,113277,10,10,0
10103,14316,112641,10,7,3
10103,22532,108052,10,10,0
10103,2684,109686,10,10,0
10108,19240,75686,7,8,1
10108,29079,88763,10,7,3
10108,8050,74958,8,8,0
10113,198,111503,8,8,0
10113,27534,112864,6,9,3
10113,7607,102266,7,5,2
10113,7039,105698,6,6,0
10113,13376,103874,6,8,2
10113,13376,111438,5,7,2
10113,32010,107362,7,5,2
10113,17801,112642,5,8,3
10133,20208,90756,8,7,1
10133,20937,108394,9,9,0
10133,20937,111507,6,10,4
10133,6881,95327,7,10,3
10133,29158,92593,5,10,5
10133,28669,101765,10,10,0
10133,20446,113464,8,8,0
10153,25865,111161,10,9,1
10153,28437,109830,10,10,0
10161,28050,110912,9,8,1
10171,7706,94761,8,4,4
10186,8162,110912,9,9,0
10186,25900,107818,8,7,1
10186,2731,107207,9,7,2
10186,16359,112442,6,4,2
10186,33752,106977,8,7,1
10217,2458,78748,10,10,0
10217,2458,105236,9,9,0
10217,14439,101507,9,10,1
10217,4667,110632,2,1,1
10217,6579,113101,6,6,0
10224,290,93010,8,7,1
10224,12903,94291,7,7,0
10224,13376,105275,7,7,0
10235,10263,110912,10,8,2
10239,16214,94012,5,8,3
10239,24406,112471,8,10,2
10239,32183,107048,10,8,2
10239,35469,88794,7,8,1
10239,6414,91680,4,10,6
10263,27314,95016,9,8,1
10263,26049,105236,9,10,1
10263,3430,110912,8,8,0
10263,2684,109040,6,10,4
10263,7311,113497,6,9,3
10279,35844,111161,10,10,0
10291,32804,75675,6,8,2
10291,11009,83944,7,9,2
10293,9283,107151,8,1,7
10293,35550,113101,8,9,1
10293,16466,110148,10,8,2
10293,17704,107688,10,9,1
10293,17704,110005,8,7,1
10318,12321,112384,8,8,0
10318,12321,113492,6,7,1
10318,34523,108358,8,8,0
10365,11009,94663,10,7,3
10382,1430,102926,8,8,0
10382,2842,112471,8,8,0
10391,17128,112471,10,9,1
10391,13793,93870,9,10,1
10440,24356,95179,5,4,1
10440,24356,110912,9,9,0
10440,12652,96895,8,7,1
10440,12652,103776,7,6,1
10440,29760,100157,8,8,0
10440,29760,105695,9,8,1
10440,29976,95963,6,9,3
10440,29976,106308,6,3,3
10495,9650,97937,9,9,0
10495,9650,99685,10,10,0
10495,9650,107207,10,10,0
10495,2677,105695,9,9,0
10495,2842,110322,9,9,0
10495,16749,102138,10,9,1
10495,22286,99088,8,7,1
10514,2927,97576,9,9,0
10514,4667,94721,9,5,4
10514,20546,106308,9,10,1
10514,32112,107688,9,8,1
10514,14436,99487,9,9,0
10528,20081,108330,6,7,1
10538,7712,99785,8,7,1
10538,7093,95327,8,8,0
10538,7093,112471,9,9,0
10538,7093,112641,9,10,1
10538,35477,93493,1,5,4
10538,17879,99653,7,9,2
10538,36058,103767,9,8,1
10541,14157,82971,10,8,2
10541,15968,80745,3,8,5
10541,23394,80684,9,10,1
10541,29760,79945,6,7,1
10541,13376,88933,6,6,0
10554,191,111161,10,9,1
10554,2684,103874,10,7,3
10557,30600,96874,6,9,3
10557,14286,92007,4,8,4
10557,21278,94336,10,8,2
10557,4889,92067,8,8,0
10557,4889,104652,7,7,0
10557,36058,107653,9,8,1
10561,24760,99685,10,9,1
10561,27487,93773,8,7,1
10579,35574,102975,8,7,1
10579,35574,103060,8,7,1
10579,35574,103064,8,10,2
10579,35574,104431,8,7,1
10579,35574,107688,10,7,3
10579,35574,109686,10,10,0
10579,35574,110475,7,8,1
10579,35574,111280,6,7,1
10579,35574,111503,7,8,1
10579,35574,113497,9,9,0
10579,29224,102510,8,8,0
10579,29224,110622,7,6,1
10579,29224,113189,10,7,3
10579,26902,105695,9,10,1
10579,26902,106308,8,8,0
10579,26902,106364,9,9,0
10579,26902,107290,10,10,0
10579,26902,109830,9,10,1
10579,26902,110357,9,10,1
10579,26902,110912,8,10,2
10579,29976,105698,10,8,2
10579,13793,103644,6,4,2
10579,13793,106697,8,8,0
10579,13793,107254,5,4,1
10579,35176,103639,10,10,0
10579,35176,112864,8,7,1
10579,34849,107659,8,7,1
10579,16250,108052,9,10,1
10579,16250,111161,8,10,2
10579,13376,106856,8,8,0
10579,13376,112384,8,8,0
10579,13376,113492,6,8,2
10579,4667,104694,9,8,1
10579,4667,111301,10,1,9
10579,3187,107977,10,7,3
10579,16969,108255,8,4,4
10579,25404,104009,6,4,2
10579,33670,104940,9,7,2
10579,27094,111070,8,9,1
10579,6623,107206,8,7,1
10579,9537,110364,8,10,2
10579,26872,103003,8,4,4
10579,26872,106677,8,7,1
10579,26872,107985,7,8,1
10579,26872,109520,8,8,0
10579,26872,112572,7,6,1
10579,13648,103939,9,8,1
10579,13648,107144,8,7,1
10579,17801,102266,7,7,0
10579,16282,104868,7,9,2
10579,21883,112499,6,3,3
10579,24174,104187,6,7,1
10579,7790,113419,6,6,0
10579,19931,106761,5,10,5
10623,33945,105793,9,7,2
10623,28902,106918,7,6,1
10623,15516,109676,6,10,4
10652,7093,105236,8,9,1
10652,7093,105695,8,10,2
10652,7093,113277,9,9,0
10652,9054,111161,9,10,1
10652,4875,105323,8,9,1
10652,9722,104348,8,7,1
10652,22368,112818,8,7,1
10652,26893,104691,8,6,2
10652,16258,103874,8,6,2
10662,6680,93773,8,8,0
10662,4246,93886,7,7,0
10667,22286,96874,8,8,0
10667,22286,99088,9,7,2
10703,35197,103064,10,7,3
10703,32294,109445,8,9,1
10703,5109,111257,8,9,1
10729,11978,97576,5,8,3
10729,30239,101414,8,8,0
10729,4137,102926,9,10,1
10729,20543,92965,5,7,2
10729,26902,104036,8,8,0
10729,14436,105265,7,9,2
10729,9283,96794,6,8,2
10729,9283,110932,5,9,4
10734,34261,111161,9,10,1
10762,2487,111161,10,10,0
10762,1183,109506,10,10,0
10762,32560,108071,10,6,4
10762,1449,110005,9,5,4
10767,1813,108052,10,10,0
10767,7447,111161,9,10,1
10802,22744,97742,7,6,1
10802,22744,113189,8,8,0
10802,4472,99685,9,10,1
10802,34060,99674,8,10,2
10802,34449,108052,9,8,1
10802,24572,93058,8,8,0
10802,24572,112641,9,9,0
10802,76,94963,6,3,3
10802,4246,106856,8,6,2
10802,13793,103919,5,7,2
10802,17800,100157,8,8,0
10802,18304,106246,8,7,1
10802,35477,104952,7,7,0
10807,26049,105236,9,10,1
10807,16282,110989,2,3,1
10807,1895,110357,6,9,3
10808,11019,113277,8,8,0
10808,11443,105695,9,9,0
10808,18878,105236,8,6,2
10808,34849,103805,7,8,1
10823,21182,107290,9,7,2
10823,34849,93777,8,8,0
10823,20446,97165,9,10,1
10832,7706,103919,9,3,6
10835,33769,112471,8,10,2
10839,32853,87363,9,3,6
10839,12059,91763,8,9,1
10839,25656,112384,9,8,1
10839,10579,93870,8,9,1
10839,34849,96754,8,10,2
10839,13376,112442,8,6,2
10845,4007,81398,9,10,1
10845,11009,71115,6,5,1
10869,5528,107822,7,9,2
10869,6414,97108,7,8,1
10869,32597,98253,7,8,1
10887,35468,94332,8,6,2
10893,23021,105236,8,9,1
10893,13795,97441,8,9,1
10898,8322,110912,10,9,1
10918,4884,60827,10,8,2
10918,32570,54389,8,9,1
10926,4105,111070,8,10,2
10932,16214,110413,8,9,1
10960,21082,81505,7,8,1
10960,9455,93177,5,9,4
10984,13087,109686,7,9,2
10984,1027,104070,7,10,3
10984,6372,104431,10,10,0
10984,25822,112641,9,9,0
10984,26872,106677,8,7,1
10984,26872,106965,5,9,4
10984,22455,109254,6,8,2
10984,35176,113114,5,10,5
10984,25404,109445,8,8,0
10984,23614,105323,8,8,0
10984,6579,112697,10,6,4
10984,14157,113247,9,7,2
10984,13648,104815,9,5,4
10984,34429,113243,6,7,1
10984,35469,110265,5,7,2
10996,32112,111161,10,10,0
10996,30691,86250,9,10,1
11009,28914,95016,10,8,2
11009,28914,95765,8,8,0
11009,28914,105695,10,8,2
11009,28914,107048,8,7,1
11009,28914,110413,8,9,1
11009,28914,113277,10,8,2
11009,7103,94012,5,5,0
11009,7103,94291,9,10,1
11009,7103,95174,8,7,1
11009,7103,96446,4,7,3
11009,7103,97216,8,7,1
11009,7103,97958,7,8,1
11009,7103,100150,8,8,0
11009,7103,102138,10,8,2
11009,7103,108394,9,6,3
11009,7103,112384,9,7,2
11009,27646,104779,7,8,1
11009,27646,109707,9,9,0
11009,13376,93870,9,10,1
11009,13376,94226,10,9,1
11009,13376,96061,7,7,0
11009,13376,99487,8,8,0
11009,13376,99674,8,8,0
11009,13376,99785,7,9,2
11009,13376,99871,8,6,2
11009,13376,100403,7,7,0
11009,13376,101540,8,8,0
11009,13376,102685,7,7,0
11009,13376,103074,6,7,1
11009,13376,103874,8,8,0
11009,13376,105690,5,8,3
11009,13376,106519,9,9,0
11009,13376,106582,8,10,2
11009,13376,106977,9,8,1
11009,13376,111255,4,7,3
11009,32570,101829,9,8,1
11009,13648,96895,10,9,1
11009,13648,96969,10,5,5
11009,13648,102926,10,5,5
11009,13648,103776,5,8,3
11009,13648,104691,8,8,0
11009,13648,105217,5,7,2
11009,13648,106677,9,7,2
11009,13648,106918,7,7,0
11009,13648,107206,9,5,4
11009,13648,110148,8,7,1
11009,13648,111503,8,7,1
11009,34849,94138,6,7,1
11009,34849,95958,3,8,5
11009,34849,95963,5,6,1
11009,8050,93822,8,8,0
11009,8050,94964,9,8,1
11009,8050,110074,7,7,0
11009,21703,94663,7,7,0
11009,21703,101410,8,6,2
11009,7093,97165,8,8,0
11009,11510,106226,9,6,3
11009,28968,104348,10,8,2
11009,20294,105793,8,2,6
11009,22900,105378,6,8,2
11009,8760,100263,7,8,1
11009,25404,107688,9,10,1
11009,20901,96933,9,6,3
11009,20901,99165,5,5,0
11009,20901,102789,3,7,4
11009,20901,102975,9,7,2
11009,20901,110771,6,6,0
11009,20901,113161,9,9,0
11009,34429,105265,9,7,2
11009,32378,104797,9,8,1
11009,19127,95250,8,7,1
11009,25878,98382,5,10,5
11009,21456,96764,8,7,1
11009,8944,110955,4,9,5
11009,9283,98621,7,6,1
11009,6623,102803,8,7,1
11009,20446,101889,7,10,3
11009,3909,104684,9,8,1
11009,10579,105698,7,10,3
11009,21149,97027,8,7,1
11009,33618,102943,5,7,2
11009,2578,113451,4,5,1
11009,16250,104850,5,10,5
11009,15644,98282,6,9,3
11009,2870,110365,8,5,3
11009,7790,100944,8,7,1
11009,11127,94747,9,9,0
11009,6414,107286,8,7,1
11009,295,94008,7,10,3
11009,15251,111477,6,7,1
11009,33711,103035,5,7,2
11009,35469,98994,7,6,1
11009,35469,109579,8,7,1
11009,35469,112857,8,6,2
11009,16282,96219,8,8,0
11009,25735,102048,8,6,2
11009,2716,100142,8,10,2
11019,17571,109830,9,9,0
11019,11461,108052,10,10,0
11019,34043,113277,8,10,2
11035,9283,88011,8,7,1
11047,20446,94608,8,9,1
11066,33421,109830,8,8,0
11066,20545,97576,9,10,1
11066,5754,110357,10,9,1
11073,17751,99685,8,10,2
11073,17751,109686,7,10,3
11073,19185,112641,8,10,2
11073,19372,106977,7,9,2
11073,32010,109040,8,9,1
11073,13648,102059,6,8,2
11073,13648,110148,7,7,0
11073,7946,110997,6,8,2
11081,27839,112864,8,8,0
11081,19185,113481,7,7,0
11081,19185,113492,6,7,1
11081,18052,112573,9,8,1
11113,27045,104431,8,6,2
11137,7640,110912,10,7,3
11137,23884,89880,10,7,3
11137,17801,95956,10,7,3
11159,10767,108052,10,10,0
11159,32207,105323,10,9,1
11200,1530,110912,10,9,1
11200,7412,106697,6,6,0
11200,17801,102057,6,9,3
11200,17801,103776,6,8,2
11200,21278,110527,6,7,1
11200,27534,110632,6,8,2
11200,6680,100403,6,5,1
11200,10579,104940,8,9,1
11200,3943,110428,7,7,0
11200,35477,105112,7,6,1
11220,3544,107207,9,9,0
11220,3544,108052,7,9,2
11220,9650,105323,8,10,2
11220,33390,107818,7,8,1
11220,27002,112573,7,10,3
11220,23678,100681,8,9,1
11234,20281,66921,7,10,3
11234,20281,112471,8,9,1
11234,3909,102926,8,7,1
11234,11371,56592,9,8,1
11234,7103,68611,7,7,0
11260,7447,111161,10,10,0
11273,8050,104029,7,8,1
11278,7103,93748,7,10,3
11278,7103,108037,6,9,3
11278,13376,89880,6,10,4
11278,13376,90728,6,9,3
11278,13376,95956,5,10,5
11282,10734,111161,10,9,1
11282,21574,92005,8,8,0
11282,23962,99785,8,8,0
11288,32557,110912,4,10,6
11288,30337,107290,9,6,3
11320,11446,95953,10,9,1
11320,8811,107207,8,8,0
11320,14674,106519,7,10,3
11364,2634,105323,9,9,0
11371,10001,108052,10,10,0
11379,25373,58385,10,10,0
11382,1488,105323,8,9,1
11411,26218,63522,9,9,0
11411,26218,64045,6,6,0
11411,26218,77289,8,5,3
11411,13376,69995,8,8,0
11411,3943,70698,5,5,0
11411,15360,74937,7,7,0
11419,7576,110413,3,8,5
11419,7576,112641,8,8,0
11428,24481,73486,10,9,1
11428,16401,82096,10,8,2
11428,7292,70735,9,8,1
11428,7292,108052,10,9,1
11428,7292,111161,10,10,0
11428,23563,68646,10,10,0
11428,23563,71562,10,10,0
11428,23563,105695,9,10,1
11428,8050,74119,10,8,2
11432,7679,103776,7,8,1
11432,26209,110413,9,9,0
11432,20546,103064,9,10,1
11432,22286,110912,9,8,1
11432,8069,112462,6,6,0
11432,4302,102685,4,8,4
11432,26540,111503,8,10,2
11443,14346,110912,10,10,0
11445,19967,94291,8,8,0
11445,25404,93748,8,8,0
11445,20533,96256,8,6,2
11445,28146,97987,5,3,2
11445,35469,109642,8,8,0
11446,14133,108052,3,7,4
11446,18125,107048,10,8,2
11446,15711,100404,7,7,0
11455,1057,111161,10,10,0
11455,23798,113277,8,7,1
11461,124,110912,10,4,6
11461,2439,110413,10,10,0
11491,24277,107207,9,10,1
11491,14241,105236,10,10,0
11499,33160,99685,10,10,0
11499,15085,80455,9,8,1
11499,10579,111503,9,7,2
11506,26826,110912,10,10,0
11507,24991,113118,10,8,2
11507,26872,109040,10,10,0
11510,2461,81398,10,10,0
11510,26872,91042,8,4,4
11510,26872,99685,10,10,0
11510,26872,106677,9,7,2
11510,26872,111257,4,10,6
11510,26872,112641,9,9,0
11510,2657,85794,8,7,1
11510,2657,88680,7,9,2
11510,2657,90863,6,8,2
11510,2657,95497,9,8,1
11510,2657,101540,6,8,2
11510,2657,106226,6,7,1
11510,11547,81573,6,8,2
11510,11547,83907,7,8,1
11510,32232,94963,6,5,1
11510,10703,99365,5,9,4
11510,13887,88847,6,10,4
11510,23311,93870,5,10,5
11510,11009,86383,9,3,6
11510,11009,97165,6,8,2
11510,8050,92991,8,7,1
11510,20294,107207,10,9,1
11510,34242,106308,6,7,1
11510,23563,101507,9,9,0
11510,14436,83929,6,8,2
11510,2207,105226,6,8,2
11510,32597,85959,8,9,1
11510,1624,92086,4,6,2
11510,26253,104036,6,8,2
11523,18304,89686,4,6,2
11523,18304,93629,6,7,1
11523,7103,87800,7,8,1
11523,7103,95174,8,7,1
11523,7103,108394,10,6,4
11543,1115,104409,6,6,0
11543,3187,112817,10,7,3
11547,35197,102685,7,10,3
11547,8488,94012,6,8,2
11547,24041,106673,8,7,1
11559,28686,111257,8,8,0
11559,26902,100758,6,8,2
11559,24914,102070,1,6,5
11560,10734,109830,9,8,1
11560,16485,102926,8,9,1
11560,13376,104389,7,7,0
11593,34060,107207,10,10,0
11593,34060,109830,9,10,1
11593,18582,111282,6,8,2
11593,16250,96438,9,10,1
11593,28259,103241,8,9,1
11593,26872,107206,8,7,1
11599,17916,103956,6,5,1
11599,8512,103644,6,7,1
11599,15251,103874,7,6,1
11599,15251,110413,8,8,0
11599,13793,109506,9,10,1
11599,13793,111686,9,8,1
11599,33265,104070,7,7,0
11599,35380,107302,7,6,1
11599,6579,104452,8,7,1
11631,20770,107290,8,9,1
11643,13793,109506,7,10,3
11644,29425,112641,8,10,2
11644,29516,112818,7,7,0
11707,4302,105121,4,7,3
11707,23913,99472,6,7,1
11707,29043,112573,7,5,2
11707,4633,96734,4,10,6
11707,15163,110632,6,8,2
11707,1555,100258,7,9,2
11707,26902,94862,7,7,0
11707,26902,104036,5,8,3
11707,13376,109831,5,8,3
11707,29204,95294,5,7,2
11707,17801,102266,4,7,3
11707,13648,100318,5,6,1
11707,4246,103759,7,5,2
11707,8050,94964,7,8,1
11707,35176,95489,6,10,4
11707,11841,99703,5,6,1
11707,28968,106881,6,7,1
11707,20446,101798,4,8,4
11707,3943,97136,3,2,1
11707,35469,102592,4,7,3
11726,32880,108399,9,8,1
11734,27751,110912,8,6,2
11734,191,111161,8,9,1
11734,1486,108052,8,10,2
11741,29046,104257,10,8,2
11749,28621,112641,7,8,1
11749,34954,103874,6,6,0
11749,9236,113277,8,8,0
11749,13648,109836,7,8,1
11770,336,102926,10,10,0
11770,12292,105236,8,8,0
11770,33015,81398,10,8,2
11770,1490,79116,9,4,5
11770,1796,92965,10,8,2
11770,12375,93105,9,5,4
11770,28968,90329,8,8,0
11770,25404,100814,7,5,2
11770,13648,83169,8,4,4
11794,29906,92099,2,10,8
11794,15085,84805,5,6,1
11841,10955,97239,7,8,1
11841,19351,107048,5,6,1
11841,26893,84805,7,9,2
11841,8050,86979,6,8,2
11841,16806,86425,6,8,2
11841,11707,99703,6,5,1
11856,18705,97165,10,7,3
11865,34565,55031,9,8,1
11865,34565,72684,7,10,3
11865,34565,107207,9,10,1
11865,17801,105793,7,7,0
11865,19127,52618,8,7,1
11866,13793,95294,7,7,0
11888,24545,110912,9,9,0
11888,24481,102926,9,9,0
11891,18892,100133,9,6,3
11891,23215,93437,8,9,1
11891,12730,70511,8,9,1
11891,18235,103939,9,8,1
11891,8985,68638,8,10,2
11891,3292,91541,8,9,1
11891,15644,80437,7,8,1
11927,1449,111257,7,8,1
11927,10113,93748,5,6,1
11934,26263,79522,5,9,4
11934,24511,75686,4,8,4
11934,24511,79817,4,8,4
11936,7447,111161,10,10,0
11936,2333,112697,8,7,1
11936,28138,105643,8,1,7
11942,6184,111161,10,10,0
11942,17086,110912,10,9,1
11961,31157,100802,10,8,2
11961,35164,107290,9,7,2
11961,11599,104070,10,7,3
11978,32905,98382,6,6,0
11978,32905,102975,9,9,0
11978,32905,111280,6,6,0
11978,19372,99088,6,10,4
11978,23390,111161,9,8,1
11978,4667,102138,8,8,0
11978,17801,105417,7,8,1
11978,18785,108147,7,6,1
11993,24511,91790,7,7,0
11993,17801,110148,9,9,0
12003,19467,110413,6,8,2
12014,13376,87298,5,6,1
12059,15948,98635,8,8,0
12059,4246,92086,6,6,0
12102,14498,95765,10,9,1
12102,12903,113492,7,4,3
12115,35477,111503,10,6,4
12162,6427,109830,9,10,1
12162,8050,104029,7,8,1
12162,11009,102048,6,8,2
12170,21891,106308,9,10,1
12170,1540,113101,5,6,1
12190,35469,45061,8,8,0
12220,7093,105236,8,9,1
12220,7093,105695,10,10,0
12220,7093,108052,10,10,0
12220,7093,110413,8,8,0
12220,7093,110912,8,10,2
12220,7093,112471,8,9,1
12220,7093,112573,9,10,1
12220,7093,112641,9,10,1
12220,7093,113277,9,9,0
12220,33653,111161,10,9,1
12220,28968,109830,10,10,0
12220,28968,112384,7,10,3
12220,28914,107048,8,7,1
12220,15163,107818,8,8,0
12220,12364,108394,6,8,2
12220,13759,106519,8,10,2
12220,21908,112851,7,1,6
12220,16806,107808,7,8,1
12220,29148,107290,8,10,2
12220,16214,112508,4,6,2
12220,13206,104815,6,7,1
12220,2839,104952,7,8,1
12220,18304,106246,7,7,0
12220,957,109045,6,7,1
12220,25085,107617,8,8,0
12239,25658,101410,10,10,0
12239,35468,93776,9,5,4
12239,35468,101414,8,7,1
12239,20446,101921,8,9,1
12292,8780,109830,9,7,2
12292,8780,110413,10,8,2
12292,8780,110912,10,6,4
12292,8780,111161,10,10,0
12292,9006,113277,8,9,1
12292,15381,110475,7,10,3
12303,10652,102926,9,8,1
12303,12220,75314,10,7,3
12306,26977,110932,8,7,1
12306,15904,112471,7,8,1
12306,28138,108037,7,7,0
12306,14439,113118,6,10,4
12321,27125,112384,8,9,1
12321,29896,113492,7,7,0
12324,35176,81505,9,10,1
12348,10077,96895,9,8,1
12348,20700,112462,7,6,1
12348,35574,99487,8,9,1
12348,23106,93779,10,5,5
12348,17801,110148,10,9,1
12348,10579,89791,8,10,2
12348,34880,87803,9,9,0
12364,29629,103064,9,9,0
12364,12220,97937,9,9,0
12364,12220,105695,8,10,2
12364,12220,108052,8,10,2
12364,12220,108394,8,6,2
12364,12220,110413,9,8,1
12364,12220,112573,10,9,1
12364,34854,107207,9,9,0
12364,22519,111507,7,6,1
12364,34565,111495,8,10,2
12370,34565,97937,8,10,2
12375,24085,109686,8,10,2
12375,19033,101507,8,9,1
12420,23563,111161,10,10,0
12435,9883,93191,8,9,1
12435,12619,57058,8,10,2
12441,7790,110989,5,4,1
12441,26872,107362,7,7,0
12441,13793,99700,7,8,1
12459,20446,66728,5,6,1
12469,12619,67541,8,9,1
12469,30964,79095,7,7,0
12469,28669,66214,3,7,4
12469,28669,70246,4,8,4
12469,28669,75654,8,8,0
12469,28669,84654,7,8,1
12469,16226,80855,8,8,0
12469,32570,67411,8,8,0
12469,12239,67805,4,9,5
12469,3943,102687,3,5,2
12469,33303,75612,8,10,2
12469,33303,77711,10,10,0
12469,7292,92067,5,8,3
12469,13492,74695,8,7,1
12485,17165,107048,8,8,0
12501,33878,112851,8,7,1
12501,10579,104694,8,9,1
12501,35477,111282,7,7,0
12504,29149,99674,7,8,1
12504,29884,102926,8,9,1
12514,2439,111161,8,10,2
12514,14295,112573,8,10,2
12514,5483,113277,9,9,0
12522,8032,109830,9,8,1
12522,8032,111161,10,9,1
12534,9254,107048,9,9,0
12534,9790,109707,10,9,1
12564,19240,112471,7,9,2
12572,7183,95765,8,10,2
12572,13937,108052,10,7,3
12572,34854,113071,5,5,0
12572,16716,93058,9,8,1
12587,211,111686,4,10,6
12587,13622,103956,4,6,2
12587,18335,93629,9,8,1
12587,18335,95742,8,7,1
12587,18335,101917,4,6,2
12587,28146,93507,8,4,4
12587,20533,104029,6,7,1
12587,13376,95956,8,10,2
12591,17724,110475,10,10,0
12591,17724,112896,10,10,0
12619,827,62136,10,8,2
12619,1134,67445,10,5,5
12619,13617,96283,9,9,0
12619,13793,69762,9,10,1
12619,13793,83907,9,7,2
12619,7103,61107,8,5,3
12619,7103,65112,7,5,2
12619,28669,58604,10,10,0
12619,28669,84335,5,10,5
12619,28669,87995,7,8,1
12619,32570,67541,9,8,1
12619,4723,58430,10,8,2
12619,4723,92593,10,8,2
12619,11009,76740,10,9,1
12619,24897,94625,9,7,2
12619,12469,58138,9,10,1
12619,22628,59719,9,6,3
12619,1621,80388,9,7,2
12619,12239,71129,10,10,0
12619,27603,65234,10,8,2
12619,9246,67334,8,6,2
12619,21230,61996,7,7,0
12619,21230,99365,10,5,5
12619,35469,62138,10,7,3
12645,1057,109830,8,8,0
12645,25906,112573,8,10,2
12645,6130,100802,8,10,2
12652,9932,110475,8,7,1
12652,9932,113497,7,8,1
12652,32010,106770,7,7,0
12652,32010,109686,9,7,2
12652,32010,112462,4,4,0
12652,26872,111070,7,9,2
12652,17801,107614,8,9,1
12652,10579,111301,3,10,7
12652,10579,113492,4,6,2
12717,18705,110527,8,7,1
12730,27156,111161,10,10,0
12730,19844,109830,10,9,1
12730,4623,110322,7,10,3
12730,25822,112641,8,9,1
12730,1170,112471,9,8,1
12730,16716,112461,8,8,0
12742,26903,109506,9,8,1
12742,13376,105435,9,7,2
12760,17110,56923,5,8,3
12770,31027,109831,7,6,1
12770,4667,107818,8,8,0
12786,8566,113277,7,9,2
12786,19614,112471,10,8,2
12807,13088,103978,6,6,0
12807,13088,106246,7,7,0
12833,13236,100114,5,8,3
12833,34429,101764,4,6,2
12850,15085,101540,9,9,0
12860,6376,110413,8,9,1
12860,9054,99685,8,9,1
12860,15784,112471,8,10,2
12860,19240,95765,8,9,1
12864,7447,111161,10,10,0
12875,1046,110413,9,9,0
12893,28160,70666,7,7,0
12893,17946,70379,9,7,2
12893,13648,106918,7,7,0
12903,22471,101540,7,8,1
12903,4529,103064,9,9,0
12903,20546,111282,7,8,1
12903,26902,99653,8,8,0
12903,26902,99685,9,10,1
12903,26902,102926,9,10,1
12903,26902,107290,8,10,2
12903,26902,110357,10,10,0
12903,19372,106977,8,9,1
12903,13376,99871,7,6,1
12903,13376,100403,8,7,1
12903,13376,100502,5,9,4
12903,13376,102685,8,7,1
12903,13376,103644,6,5,1
12903,13376,107211,6,5,1
12903,13376,112384,7,8,1
12903,13376,113492,4,8,4
12903,4667,99365,6,5,1
12903,4667,108550,7,9,2
12903,4667,113627,8,7,1
12903,8760,110475,7,7,0
12903,13793,104692,5,7,2
12903,11978,102975,7,9,2
12903,13648,105327,8,8,0
12903,4973,104265,7,6,1
12928,33117,105236,7,9,2
12928,1449,111257,8,8,0
12928,27824,105435,6,10,4
12928,20586,99371,4,8,4
12928,13376,111255,2,7,5
12928,17801,103855,3,8,5
12953,15906,91790,8,9,1
12953,7790,90142,8,6,2
12953,11707,84945,6,4,2
12965,15525,110912,9,6,3
12965,35469,71129,7,8,1
12996,21230,94011,8,7,1
12996,28669,86197,8,8,0
13013,8050,73486,9,8,1
13014,19581,113247,10,7,3
13014,22368,103639,8,8,0
13021,2684,81505,10,10,0
13021,12645,93058,10,7,3
13021,20062,113101,10,8,2
13038,4667,108052,9,8,1
13043,29148,107290,7,10,3
13043,31096,76740,8,7,1
13059,20956,111161,10,10,0
13059,24613,113277,10,9,1
13059,25058,110322,10,8,2
13061,15152,103064,10,10,0
13061,16225,107048,9,8,1
13084,27909,95765,10,8,2
13088,12807,103978,6,6,0
13088,12807,106246,7,7,0
13088,25404,111503,7,9,2
13121,33653,102926,9,9,0
13121,33653,105236,8,8,0
13121,2136,87469,5,8,3
13121,12102,88847,7,10,3
13121,12102,95765,10,10,0
13121,17800,92005,8,7,1
13121,17800,92099,8,6,2
13121,2867,99611,9,8,1
13121,21519,90728,5,7,2
13138,24561,111161,10,8,2
13138,34277,112818,8,7,1
13146,4123,85407,8,8,0
13158,25404,80120,8,6,2
13206,27866,107614,6,8,2
13206,24477,111503,8,4,4
13223,133,86190,6,10,4
13223,4502,88763,8,10,2
13223,4502,94721,7,7,0
13236,14420,99088,8,8,0
13236,4302,100114,8,6,2
13236,17590,111282,8,8,0
13252,18341,105236,10,10,0
13252,21047,109830,10,10,0
13252,35082,99785,8,8,0
13252,21224,102138,8,9,1
13252,1634,99487,10,9,1
13252,3187,97958,8,9,1
13269,29086,96256,6,10,4
13269,11009,96446,6,4,2
13284,3367,99810,10,8,2
13284,7103,101393,8,6,2
13301,34565,72684,4,10,6
13301,34565,95953,9,10,1
13301,34565,107207,9,10,1
13301,34565,113247,7,10,3
13301,2458,75148,9,8,1
13326,6184,111161,9,10,1
13330,22643,81505,9,9,0
13330,26049,105236,8,10,2
13376,3292,94721,9,8,1
13376,3292,99088,9,10,1
13376,3292,99141,5,8,3
13376,3292,99785,9,8,1
13376,3292,103064,9,9,0
13376,3292,104291,6,9,3
13376,3292,106582,10,7,3
13376,3292,106697,7,8,1
13376,3292,111161,10,8,2
13376,26902,94226,9,10,1
13376,26902,94862,10,7,3
13376,26902,95016,10,10,0
13376,26902,95742,7,5,2
13376,26902,97958,7,9,2
13376,26902,99685,10,10,0
13376,26902,99700,6,7,1
13376,26902,100157,9,10,1
13376,26902,103919,7,8,1
13376,26902,105121,7,7,0
13376,26902,106308,8,8,0
13376,26902,109830,8,10,2
13376,26902,111257,8,8,0
13376,26902,111686,7,6,1
13376,26902,112442,6,10,4
13376,26902,113277,9,10,1
13376,13793,95271,7,8,1
13376,13793,99253,8,7,1
13376,13793,100502,9,8,1
13376,13793,100802,9,10,1
13376,13793,101917,6,5,1
13376,13793,103644,5,4,1
13376,13793,103956,6,5,1
13376,13793,107254,4,4,0
13376,13793,113253,6,5,1
13376,12903,95705,9,8,1
13376,12903,96071,6,7,1
13376,12903,99871,6,7,1
13376,12903,100403,7,8,1
13376,12903,101540,8,7,1
13376,12903,102685,7,8,1
13376,12903,106977,8,8,0
13376,12903,107211,5,6,1
13376,12903,111282,8,7,1
13376,12903,112384,8,7,1
13376,12903,113492,8,4,4
13376,17801,94137,7,8,1
13376,17801,94737,8,8,0
13376,17801,95956,10,7,3
13376,17801,96874,8,8,0
13376,17801,99423,9,8,1
13376,17801,99810,8,8,0
13376,17801,101272,7,7,0
13376,17801,102798,7,8,1
13376,17801,103874,8,8,0
13376,17801,104389,7,8,1
13376,17801,105417,5,8,3
13376,17801,109686,8,8,0
13376,34849,95990,7,5,2
13376,34849,96754,8,10,2
13376,34849,98554,7,8,1
13376,34849,99371,7,5,2
13376,34849,109445,10,10,0
13376,34849,110678,7,4,3
13376,4667,99674,8,5,3
13376,4667,102510,7,6,1
13376,4667,106856,8,7,1
13376,4667,110413,9,9,0
13376,4667,112722,6,5,1
13376,25404,95327,9,7,2
13376,25404,96061,7,7,0
13376,25404,103074,7,7,0
13376,25404,111438,7,7,0
13376,341,107034,6,8,2
13376,3187,97474,7,6,1
13376,3187,99487,8,7,1
13376,3187,110622,6,7,1
13376,8760,106519,9,6,3
13376,2867,97493,8,9,1
13376,2867,97527,10,7,3
13376,26872,99938,6,10,4
13376,26872,109190,7,3,4
13376,15124,111255,7,6,1
13376,6623,105690,8,6,2
13376,6579,95159,7,6,1
13376,7103,105435,7,8,1
13376,36058,109831,8,5,3
13376,36058,111149,9,8,1
13376,13801,109254,5,7,2
13376,31674,107978,6,6,0
13376,18596,103873,9,10,1
13376,31807,101492,9,8,1
13376,6414,94890,5,5,0
13376,10224,105275,7,7,0
13376,3580,105104,8,5,3
13376,25465,101279,7,8,1
13376,11035,107711,6,8,2
13377,46,104466,8,9,1
13394,9650,105323,10,10,0
13394,9650,107207,10,10,0
13394,2842,110322,10,9,1
13394,2842,112573,10,10,0
13394,13759,105695,9,10,1
13394,9236,110912,10,9,1
13394,32557,102926,10,9,1
13394,32495,101540,8,8,0
13394,14674,112461,8,7,1
13394,12220,107808,8,7,1
13419,1046,105236,9,8,1
13440,29639,69947,7,6,1
13440,11510,64208,6,9,3
13440,36058,108052,8,10,2
13461,31613,95765,9,8,1
13479,25549,106677,9,8,1
13492,11961,107290,8,9,1
13492,31157,93409,7,7,0
13492,2867,99871,7,10,3
13492,16706,89175,7,1,6
13492,22848,74806,6,7,1
13492,22848,102926,8,8,0
13492,2347,104409,4,6,2
13492,6767,97733,8,8,0
13492,6767,104714,8,7,1
13492,7946,103241,8,10,2
13492,8624,79501,6,7,1
13492,23598,82694,7,6,1
13492,30480,89530,5,9,4
13492,27184,110357,8,10,2
13492,33618,91474,7,9,2
13492,20446,78875,6,10,4
13492,26218,70791,7,9,2
13492,4667,96734,9,6,3
13492,20084,97441,7,10,3
13492,6414,72251,6,9,3
13492,6414,90098,5,7,2
13492,9145,74695,7,8,1
13492,9145,96320,5,7,2
13492,25404,107050,8,8,0
13498,32232,80678,9,9,0
13498,15846,111161,9,10,1
13519,7706,103074,9,8,1
13533,15356,109830,9,8,1
13533,17801,109686,6,8,2
13540,4193,70328,7,7,0
13572,28968,110413,7,9,2
13572,28968,112384,7,10,3
13572,22037,93748,8,8,0
13572,8495,88847,9,9,0
13572,4335,97216,7,10,3
13572,2657,88680,9,9,0
13580,36058,54215,8,8,0
13580,23678,54698,9,8,1
13617,34880,96283,9,8,1
13617,34565,92067,9,10,1
13620,24477,99077,7,9,2
13622,12587,103956,6,4,2
13648,18053,113189,8,8,0
13648,22856,103776,8,10,2
13648,15251,102926,5,8,3
13648,15251,103874,5,6,1
13648,15251,108399,8,7,1
13648,15251,110148,7,7,0
13648,11009,99871,7,8,1
13648,11009,100150,7,8,1
13648,11009,101540,5,8,3
13648,11009,104691,8,8,0
13648,11009,105217,7,5,2
13648,11009,105695,5,10,5
13648,11009,106677,7,9,2
13648,11009,106918,7,7,0
13648,11009,106977,5,9,4
13648,11009,107206,5,9,4
13648,11009,109707,5,9,4
13648,11009,111503,7,8,1
13648,11009,112384,8,9,1
13648,18098,103639,5,8,3
13648,35794,99685,8,8,0
13648,13376,112722,5,6,1
13648,18785,104815,5,10,5
13648,18785,112851,7,9,2
13648,10579,101414,9,8,1
13648,10579,103939,8,9,1
13648,10579,104940,5,9,4
13648,10579,107144,7,8,1
13648,10579,107659,7,8,1
13648,26872,105327,8,5,3
13648,25404,110632,7,8,1
13648,27983,107091,5,9,4
13648,29906,104257,8,10,2
13648,11073,102059,8,6,2
13648,9283,104231,7,1,6
13648,9283,105414,6,7,1
13648,23647,111742,7,7,0
13648,14436,108473,6,7,1
13648,4246,112401,5,6,1
13648,12220,106246,5,7,2
13648,24174,109836,8,6,2
13648,12431,100318,6,7,1
13648,25399,102951,6,8,2
13657,18776,111161,9,10,1
13657,23645,108052,9,9,0
13681,16157,94226,8,8,0
13681,2684,109686,7,10,3
13681,16716,98635,7,8,1
13681,6623,96061,4,8,4
13704,11220,86979,8,7,1
13712,1411,103064,10,9,1
13713,22869,93870,6,9,3
13713,11009,107206,6,9,3
13722,17801,107798,5,9,4
13723,2326,106977,10,9,1
13723,35550,109444,8,8,0
13723,20469,108037,8,1,7
13759,24277,105695,10,10,0
13759,12220,106519,10,8,2
13759,28259,88930,7,8,1
13789,17667,87332,9,7,2
13789,4246,83131,7,5,2
13793,15648,102926,10,10,0
13793,24356,107254,4,4,0
13793,13376,99253,7,8,1
13793,13376,99700,8,6,2
13793,13376,100502,8,9,1
13793,13376,100802,10,9,1
13793,13376,101917,5,6,1
13793,13376,103064,10,9,1
13793,13376,103644,4,5,1
13793,13376,103919,7,7,0
13793,13376,103956,5,6,1
13793,13376,106697,8,7,1
13793,13376,111686,8,7,1
13793,13376,113253,5,6,1
13793,29976,111503,8,7,1
13793,10579,107290,10,10,0
13793,5933,112471,8,8,0
13793,11599,97981,6,5,1
13793,11599,109506,10,9,1
13793,30035,98084,8,6,2
13793,7582,99994,6,7,1
13793,7582,110978,3,3,0
13793,14926,110632,9,8,1
13793,30905,113481,2,6,4
13793,28437,104409,6,4,2
13793,12903,104692,7,5,2
13793,32727,113540,9,6,3
13793,6767,102034,2,8,6
13795,29079,110912,8,9,1
13795,18776,111161,10,10,0
13795,31648,104797,10,9,1
13801,6150,103064,9,7,2
13801,6150,103644,7,6,1
13801,32442,110148,8,7,1
13801,16969,113189,8,10,2
13801,33670,104431,7,7,0
13801,29224,109040,8,8,0
13801,35574,112281,6,8,2
13801,17535,101272,4,7,3
13801,17801,112642,4,8,4
13801,9790,109254,7,4,3
13818,30558,96446,10,3,7
13818,14157,88847,9,7,2
13825,20016,110413,10,8,2
13825,24825,103064,10,10,0
13825,24545,104652,9,8,1
13829,221,99674,10,8,2
13848,2842,94737,7,8,1
13848,13376,91042,9,10,1
13887,16485,92005,10,7,3
13887,13376,97493,9,8,1
13923,302,112740,8,9,1
13923,7240,113277,8,8,0
13923,6623,106950,5,6,1
13928,4007,90728,8,8,0
13937,21921,108052,7,10,3
13961,11009,51201,10,7,3
13995,29313,99685,10,9,1
13995,7640,81505,10,7,3
14017,17801,104257,10,8,2
14054,4529,76759,5,9,4
14058,19066,103064,8,9,1
14085,8969,91763,10,10,0
14085,40,108399,10,6,4
14085,5655,66819,10,6,4
14085,13376,67824,10,8,2
14120,2120,112471,7,9,2
14120,18420,97165,7,8,1
14120,26872,104714,5,8,3
14120,9455,103919,7,8,1
14120,30148,97731,6,7,1
14120,32180,113627,7,7,0
14120,30600,112818,7,8,1
14133,33969,107818,7,7,0
14133,13657,108052,7,9,2
14139,4605,90605,10,9,1
14139,17590,97733,7,9,2
14139,22457,84726,7,6,1
14139,22457,104348,10,8,2
14139,33794,85995,8,8,0
14139,14329,88944,7,6,1
14139,29224,110622,7,6,1
14139,11009,88930,6,4,2
14139,11200,105112,6,7,1
14157,27953,110912,8,8,0
14157,15363,97165,8,8,0
14157,2867,97814,6,9,3
14157,34477,104691,8,8,0
14157,5352,113247,7,8,1
14157,24212,108211,7,9,2
14159,133,86190,7,10,3
14224,18193,111161,10,8,2
14224,28138,110475,9,8,1
14228,3320,97428,7,9,2
14228,2309,110632,10,6,4
14228,16282,97778,7,5,2
14238,6659,65571,10,7,3
14241,11491,105236,10,10,0
14241,24277,105323,9,10,1
14241,1425,108550,10,5,5
14241,32075,112851,10,2,8
14241,15987,105793,8,5,3
14241,25465,101279,10,8,2
14247,3762,86960,9,9,0
14253,19829,99088,7,7,0
14269,32597,56732,7,10,3
14286,32905,111280,7,6,1
14286,26902,106308,9,8,1
14286,3187,107977,6,7,1
14286,4667,106582,8,8,0
14286,4667,112722,7,5,2
14286,34849,107953,7,5,2
14286,34849,110678,8,4,4
14286,16749,109303,8,8,0
14286,11009,110955,9,4,5
14286,34429,113326,8,8,0
14295,27156,111161,10,10,0
14295,26239,112573,10,7,3
14295,8322,110912,7,9,2
14305,9178,109830,9,8,1
14305,35067,81505,4,9,5
14315,10802,70735,9,9,0
14315,28914,105695,9,8,1
14316,29425,112641,7,10,3
14326,11066,109830,10,8,2
14326,11443,105695,8,9,1
14326,34225,99487,9,9,0
14326,3892,112384,8,6,2
14329,31460,99685,10,10,0
14329,16225,110912,8,9,1
14329,17704,109445,8,8,0
14329,28968,97958,6,8,2
14329,4123,91129,5,7,2
14341,23087,109707,8,8,0
14341,13793,110978,4,3,1
14341,13376,105121,3,7,4
14341,7103,98258,6,9,3
14341,25404,95925,3,7,4
14358,30449,106977,7,8,1
14358,2731,109830,8,8,0
14365,30925,54215,10,10,0
14369,35792,72890,7,7,0
14411,133,86190,8,10,2
14417,29889,109830,10,7,3
14417,2772,107614,10,9,1
14420,9163,99088,8,7,1
14428,4884,78841,7,7,0
14428,28914,56217,8,8,0
14428,10018,49261,8,7,1
14428,7292,73312,7,7,0
14428,27137,67140,8,7,1
14428,11009,65207,7,10,3
14428,32597,60176,7,9,2
14428,12469,46414,6,4,2
14436,33653,102926,10,9,1
14436,33653,108052,10,9,1
14436,33653,110912,10,9,1
14436,33653,111161,10,9,1
14436,2927,104257,8,9,1
14436,8760,109040,9,5,4
14436,8760,109686,8,4,4
14436,8760,110148,8,6,2
14436,28968,103874,8,7,1
14436,30667,108399,9,10,1
14436,10729,105265,9,7,2
14436,9283,110950,9,6,3
14436,13648,108473,7,6,1
14436,19262,105415,7,10,3
14439,32112,111161,10,10,0
14439,17751,109506,10,10,0
14439,35765,107554,10,7,3
14439,12364,105695,10,8,2
14439,2827,101507,10,8,2
14439,2827,112819,10,7,3
14439,26902,98084,10,8,2
14439,26902,113118,10,10,0
14439,4335,99939,10,10,0
14447,1210,97239,5,8,3
14447,2342,78788,9,8,1
14496,23647,104181,8,5,3
14496,24511,98258,9,9,0
14498,17801,99423,8,8,0
14498,17801,99810,7,8,1
14498,17801,104714,6,8,2
14498,17801,107818,9,8,1
14498,17801,111257,9,9,0
14498,17801,112864,9,8,1
14498,24481,105323,10,9,1
14498,4667,105112,7,4,3
14498,19252,100054,8,7,1
14498,13376,111255,5,7,2
14505,26872,112508,7,7,0
14516,32539,109446,8,6,2
14516,22499,98724,8,9,1
14523,18630,71562,9,9,0
14523,21240,99674,8,8,0
14553,5703,102926,8,9,1
14553,26903,109686,10,9,1
14553,16476,106918,8,8,0
14553,12903,105327,7,8,1
14573,22848,93773,8,8,0
14573,13761,111161,10,10,0
14573,13376,111149,8,9,1
14592,5505,111161,8,9,1
14592,11137,110912,10,10,0
14592,26808,110413,9,9,0
14592,25071,109686,8,9,1
14592,17801,107211,7,7,0
14592,17801,110475,7,8,1
14599,7851,102926,9,7,2
14599,11506,110912,10,10,0
14599,12753,107290,8,10,2
14599,16292,113118,8,9,1
14599,23913,109035,6,8,2
14599,27714,105428,6,10,4
14604,33304,102926,7,10,3
14604,31620,109830,7,8,1
14628,26621,88847,7,10,3
14628,11066,88763,10,9,1
14630,29313,110413,9,8,1
14630,9650,107207,10,10,0
14630,9650,109830,10,10,0
14630,20106,105236,8,7,1
14630,20106,112573,10,9,1
14674,1488,105323,10,9,1
14674,1488,107207,10,10,0
14674,9650,109830,10,10,0
14674,18136,105695,9,9,0
14674,18136,106519,10,9,1
14674,18136,112573,10,10,0
14674,16716,112461,7,8,1
14674,24629,113247,10,10,0
14674,25465,112870,8,8,0
14675,25404,109445,7,8,1
14675,25549,95497,7,8,1
14675,36058,111149,6,8,2
14736,21168,104694,7,8,1
14753,20195,98519,10,5,5
14753,13376,89173,10,2,8
14755,9496,89489,8,8,0
14755,2496,90849,5,3,2
14755,20937,93191,5,8,3
14755,11009,94663,8,7,1
14755,7706,103905,4,4,0
14782,7103,111495,7,8,1
14782,7103,111507,8,8,0
14782,21728,97814,7,8,1
14845,21370,99785,8,9,1
14845,577,100758,9,7,2
14926,21891,106308,8,10,2
14926,13793,110632,8,9,1
14926,26902,112442,8,10,2
14967,29639,94226,10,8,2
14972,22819,103874,8,10,2
14972,32539,112722,8,7,1
14972,23444,78748,10,3,7
14972,16235,82402,7,5,2
14972,22953,113277,10,10,0
14972,4573,101917,1,4,3
14972,27045,86979,6,7,1
14972,27045,101410,7,6,1
14972,13793,103644,4,4,0
14972,7103,100150,6,8,2
14972,24897,79944,7,8,1
14972,6579,96463,9,6,3
14972,11009,110074,8,7,1
14972,20446,82736,8,10,2
14995,10652,95647,9,8,1
14995,19127,81070,10,6,4
15072,11432,110912,10,9,1
15072,6579,107507,7,8,1
15072,6579,113101,6,6,0
15072,10391,112471,8,10,2
15072,4884,108399,10,7,3
15072,31934,109348,9,8,1
15083,191,111161,10,9,1
15085,6642,90329,8,8,0
15085,34565,85334,9,8,1
15085,34565,94226,7,9,2
15085,21047,109830,10,10,0
15085,36058,101540,9,8,1
15085,8050,93822,7,8,1
15085,28698,86879,9,8,1
15085,18459,104797,7,9,2
15085,24002,105236,8,8,0
15085,2776,97958,7,9,2
15085,11794,84805,6,5,1
15085,9413,108550,8,9,1
15085,13648,113189,8,8,0
15085,6579,93105,8,4,4
15085,16806,82979,9,7,2
15085,20446,91217,9,9,0
15085,11707,96734,10,4,6
15091,15360,104691,10,10,0
15092,9283,110478,10,6,4
15124,20546,113481,4,7,3
15124,4502,107614,9,7,2
15124,4502,111070,7,8,1
15124,32112,107688,7,8,1
15124,28050,112740,9,9,0
15124,211,111686,8,10,2
15124,26902,111257,10,8,2
15124,3292,104940,8,10,2
15124,13376,101917,5,6,1
15124,13376,111255,6,7,1
15124,9932,113497,8,8,0
15124,17801,98536,6,8,2
15124,34849,112715,8,5,3
15124,17946,100944,8,7,1
15124,15516,109676,2,10,8
15124,35219,99740,3,6,3
15127,12249,112471,3,10,7
15141,5675,97937,9,9,0
15141,34854,112641,9,8,1
15163,16533,105236,9,7,2
15163,16533,108052,10,10,0
15163,31538,107818,8,7,1
15163,19033,110632,8,9,1
15163,7706,113497,7,7,0
15163,32010,106770,7,7,0
15199,133,86190,10,10,0
15199,19372,109830,9,10,1
15221,76,106977,6,10,4
15221,13376,105275,9,7,2
15225,28600,97165,9,7,2
15233,4007,107818,6,9,3
15233,21974,90670,10,8,2
15239,13376,83550,3,6,3
15251,25999,112462,7,5,2
15251,6643,113277,8,9,1
15251,17421,110413,8,8,0
15251,17421,110912,7,8,1
15251,2684,110475,8,10,2
15251,2684,112281,7,10,3
15251,28050,112864,8,9,1
15251,11009,111477,7,6,1
15258,1844,86393,7,8,1
15258,21370,113189,9,7,2
15261,27526,107048,8,9,1
15261,12364,112573,10,10,0
15276,18776,105323,10,10,0
15356,13533,109830,8,9,1
15356,27883,112471,9,9,0
15356,31157,112384,7,8,1
15360,15091,104691,10,10,0
15360,5649,93773,9,8,1
15360,7051,93437,9,7,2
15360,30600,88763,10,10,0
15360,10839,79945,7,8,1
15360,10839,96754,9,8,1
15360,11978,84726,9,7,2
15360,11978,85936,9,7,2
15360,11978,88170,7,6,1
15360,11978,92007,10,7,3
15360,11978,98382,4,6,2
15360,11978,102975,8,9,1
15360,29349,91223,10,4,6
15360,19988,83944,9,7,2
15360,18076,112471,8,8,0
15360,11200,106697,7,6,1
15360,11200,110527,7,6,1
15360,7529,78869,5,5,0
15360,7529,95016,10,7,3
15360,12485,78748,9,8,1
15360,13801,88247,10,9,1
15360,13801,88944,8,7,1
15360,13801,90605,10,10,0
15360,13801,103644,5,7,2
15360,34044,89945,10,8,2
15360,32597,104652,8,7,1
15360,2867,93220,10,5,5
15360,6767,97444,6,6,0
15360,25404,82431,1,8,7
15360,27045,96454,8,6,2
15381,29058,113277,10,7,3
15381,8733,110912,8,9,1
15381,32207,111161,9,10,1
15381,26049,110413,10,10,0
15381,12292,110475,10,7,3
15394,8438,112573,8,10,2
15394,2731,102926,8,7,1
15394,21718,111161,9,9,0
15394,29163,108160,6,8,2
15440,3128,111161,10,10,0
15440,4623,110322,9,10,1
15444,18257,113492,5,7,2
15444,7073,107978,4,4,0
15516,10623,109676,10,6,4
15516,3187,107977,10,7,3
15516,26872,112792,8,8,0
15516,10579,112499,8,6,2
15516,31275,107750,7,8,1
15525,8155,110912,6,10,4
15525,34477,108550,8,10,2
15525,1089,107688,7,8,1
15525,7529,100802,7,8,1
15562,8050,110074,7,7,0
15562,7103,113409,8,6,2
15562,11009,91474,8,7,1
15604,22253,110912,10,9,1
15617,14519,90967,6,7,1
15632,25941,110413,8,8,0
15632,1234,112384,7,8,1
15632,31617,105236,8,7,1
15644,6184,111161,10,10,0
15644,16250,108052,8,10,2
15644,4667,97165,8,5,3
15644,4667,102138,10,8,2
15644,4667,105236,9,9,0
15644,4316,94226,10,8,2
15644,14436,93407,8,9,1
15644,14436,93822,9,9,0
15644,14436,102926,9,10,1
15644,948,105323,10,2,8
15644,25404,98206,9,8,1
15644,26872,102526,9,6,3
15644,23647,96933,8,7,1
15644,18705,98282,9,6,3
15644,20446,95270,7,8,1
15644,34849,94012,8,8,0
15644,22856,94889,7,3,4
15644,9283,94812,8,10,2
15644,18634,95897,8,6,2
15644,10557,107653,8,9,1
15648,27487,102926,10,8,2
15648,7103,113409,3,6,3
15648,2867,109415,5,6,1
15650,10652,97165,9,7,2
15650,1241,87884,10,10,0
15660,10133,111507,10,6,4
15660,15846,107822,5,7,2
15660,7529,110950,10,6,4
15682,1372,71877,8,8,0
15682,10538,95327,9,8,1
15682,7646,74102,8,6,2
15682,3943,91369,8,7,1
15682,13121,81633,7,3,4
15682,32183,82010,8,9,1
15682,8050,71230,8,7,1
15682,20446,85809,10,9,1
15691,17128,112471,9,9,0
15706,8969,110413,8,9,1
15706,8610,113247,10,9,1
15711,11446,100404,7,7,0
15715,29734,108052,10,7,3
15715,22862,101414,10,8,2
15715,19611,107290,10,7,3
15715,13681,98635,10,7,3
15723,21728,89881,9,10,1
15723,25147,102926,7,10,3
15723,22628,104348,9,8,1
15729,24511,112471,9,9,0
15761,3925,113627,7,7,0
15761,11593,107207,8,10,2
15761,30411,101414,6,10,4
15763,21230,58329,10,7,3
15784,20344,110912,8,10,2
15784,11159,105236,8,10,2
15784,25058,112471,10,8,2
15799,18136,110932,9,9,0
15801,28138,112281,9,9,0
15819,34565,95953,9,10,1
15830,19012,79944,10,10,0
15830,11044,101318,8,8,0
15830,19127,86216,10,7,3
15830,19127,107653,9,9,0
15830,35550,108394,9,8,1
15840,21072,108052,10,9,1
15840,26872,109830,10,9,1
15846,13498,111161,10,9,1
15846,34793,108052,10,9,1
15846,21023,110912,9,9,0
15846,31614,109830,8,9,1
15846,16654,112579,7,9,2
15846,28926,107943,8,4,4
15846,23647,107822,7,8,1
15856,13657,86250,7,8,1
15856,24991,92965,8,8,0
15856,4007,107818,8,9,1
15863,12572,95765,9,8,1
15863,13648,109707,5,5,0
15877,29781,110912,9,8,1
15877,1488,102926,9,9,0
15877,17704,112818,7,8,1
15896,6642,104257,9,9,0
15904,21863,111161,10,9,1
15904,19168,112471,8,8,0
15904,10103,112641,10,10,0
15906,9932,102798,9,7,2
15906,18420,106677,6,9,3
15906,5567,103639,8,8,0
15941,32387,110413,7,10,3
15941,34854,87843,10,9,1
15941,36058,104348,9,3,6
15948,8050,61722,8,8,0
15948,5967,75314,9,9,0
15948,11282,99785,7,8,1
15948,12059,98635,8,8,0
15948,30220,78748,9,10,1
15948,29841,73195,10,10,0
15948,9294,64115,7,8,1
15948,24465,99685,9,9,0
15948,13761,74285,7,8,1
15948,34565,109445,6,10,4
15948,19967,82010,8,7,1
15948,13376,107211,6,5,1
15963,31305,91778,5,5,0
15964,13928,90728,10,8,2
15964,14436,105265,8,9,1
15965,11506,107818,7,10,3
15965,9145,102138,10,9,1
15965,18788,95715,7,9,2
15968,22848,103644,8,5,3
15968,27487,103064,9,8,1
15968,19185,99785,10,8,2
15968,1411,100403,8,9,1
15968,4605,105695,10,8,2
15968,4605,113189,6,8,2
15968,24709,109506,8,8,0
15968,32499,112573,9,9,0
15968,19182,96928,7,7,0
15968,31745,105793,7,10,3
15968,6579,98645,5,3,2
15968,10042,96764,8,7,1
15987,20708,110912,7,10,3
15987,34261,111161,8,10,2
15987,9878,95765,7,10,3
15987,35510,105236,7,6,1
15987,31745,105793,5,10,5
15987,11282,92005,8,8,0
15987,7093,93105,6,7,1
15987,16716,94012,4,6,2
15987,19033,109445,4,8,4
15987,3943,106387,4,6,2
16048,34546,90605,8,8,0
16048,34546,103644,6,6,0
16048,8050,102494,7,7,0
16079,4316,89530,6,6,0
16079,5423,93870,7,8,1
16079,23647,97027,7,7,0
16079,3292,89218,6,10,4
16092,9006,99685,10,9,1
16092,15394,112573,10,8,2
16119,28871,97239,8,6,2
16139,9455,99685,7,9,2
16157,1759,111161,9,10,1
16157,26063,105236,8,8,0
16157,29058,113277,6,7,1
16174,29976,107362,6,6,0
16174,20546,111282,6,8,2
16174,10579,111301,3,10,7
16175,16157,113277,7,6,1
16175,6623,91064,7,8,1
16179,11428,56592,8,10,2
16179,13021,59578,9,9,0
16214,10932,110413,9,8,1
16214,26808,107688,9,7,2
16214,20145,104652,7,6,1
16214,12220,112508,6,4,2
16225,31490,110912,9,9,0
16225,18052,110413,8,7,1
16225,6184,111161,10,10,0
16225,29432,109830,10,9,1
16225,35176,113189,10,10,0
16226,18501,87332,8,8,0
16226,28669,87995,10,8,2
16226,28669,109508,10,9,1
16226,27137,110057,10,8,2
16226,12469,80855,8,8,0
16226,32597,79470,10,7,3
16229,11510,104036,10,6,4
16235,14972,82402,5,7,2
16244,26872,111257,8,10,2
16250,34429,108052,10,8,2
16250,34429,110413,10,9,1
16250,34429,110912,9,8,1
16250,34429,111161,10,9,1
16250,34429,112641,10,9,1
16250,34429,113277,10,8,2
16250,20294,107048,10,6,4
16250,20294,108358,10,9,1
16250,8780,107290,10,7,3
16250,29760,103874,9,7,2
16250,29760,106977,10,8,2
16250,29760,112462,7,8,1
16250,10579,111503,10,7,3
16250,25404,111282,10,7,3
16250,4667,107362,8,2,6
16250,20539,112401,8,7,1
16250,11009,104850,10,5,5
16250,14286,109303,9,8,1
16258,17724,103874,6,10,4
16258,34880,92563,9,7,2
16282,17801,107614,8,9,1
16282,17801,107818,9,8,1
16282,17801,110475,7,8,1
16282,17801,110912,9,9,0
16282,17801,111257,8,9,1
16282,3292,105698,9,7,2
16282,13376,107034,8,6,2
16282,3320,104868,9,9,0
16282,3320,109520,8,8,0
16282,3320,110364,9,6,3
16282,27881,107144,8,10,2
16282,26872,105211,9,10,1
16282,26872,107387,6,10,4
16282,26872,107478,7,8,1
16282,26872,107985,8,8,0
16282,33438,110989,3,10,7
16282,28166,107808,9,9,0
16282,30558,112883,9,6,3
16282,28450,104952,8,8,0
16292,14599,113118,9,8,1
16292,16623,107554,7,9,2
16294,13648,92099,7,7,0
16294,7103,101917,3,2,1
16299,7956,105236,8,8,0
16304,24205,100507,7,6,1
16304,22862,101414,8,8,0
16304,32010,111257,8,7,1
16304,17801,113189,7,8,1
16323,6009,97576,8,9,1
16323,373,105236,6,8,2
16336,16716,113161,8,6,2
16336,3461,99674,7,7,0
16336,1492,95675,8,7,1
16344,34565,69281,8,10,2
16354,20145,109040,7,7,0
16354,20145,112281,7,7,0
16359,10186,112442,4,6,2
16359,19927,109830,9,5,4
16401,1456,86879,9,10,1
16401,9878,95765,8,10,2
16401,6927,96283,8,7,1
16401,22090,86541,5,7,2
16452,124,102926,9,9,0
16465,16716,96969,8,5,3
16466,13801,110148,8,8,0
16466,26872,112792,8,8,0
16476,6628,104797,7,10,3
16476,2677,111257,8,8,0
16476,2677,112641,8,9,1
16476,29106,106226,5,10,5
16476,32180,107048,8,7,1
16476,32967,110148,7,9,2
16476,20849,106918,8,6,2
16485,11560,109830,9,9,0
16485,27156,111161,9,10,1
16485,14295,110912,8,7,1
16485,14295,112573,9,10,1
16485,10001,108052,9,10,1
16485,555,110357,9,8,1
16500,33421,103064,8,7,1
16500,18136,94226,8,8,0
16500,30239,91763,8,9,1
16500,26902,100157,7,10,3
16500,5352,102057,6,8,2
16512,17796,99487,7,10,3
16512,17796,110413,10,8,2
16512,22286,109830,10,9,1
16512,9006,100150,10,8,2
16533,4623,108052,10,10,0
16533,12962,97165,7,10,3
16533,15163,105236,7,9,2
16556,4623,108550,8,10,2
16556,336,107818,8,10,2
16556,124,110912,7,4,3
16556,3465,107048,8,7,1
16579,14295,109830,8,10,2
16579,14295,110912,8,7,1
16579,302,112740,8,9,1
16590,9283,103074,7,10,3
16593,17714,59740,9,9,0
16593,17714,60748,10,10,0
16593,17714,65126,10,10,0
16593,28669,76162,9,7,2
16593,11009,85780,10,2,8
16593,18674,60232,10,10,0
16593,28904,63452,8,2,6
16600,22455,93870,9,7,2
16623,13087,109686,10,9,1
16623,26091,110950,9,9,0
16623,32335,112641,8,10,2
16623,3620,113277,10,8,2
16623,16485,107048,8,4,4
16623,26902,109506,9,10,1
16623,17801,107614,9,9,0
16623,17801,108160,10,8,2
16623,27824,112346,9,9,0
16623,23533,107822,8,9,1
16623,16292,107554,9,7,2
16623,3632,110167,6,10,4
16623,7790,112819,7,6,1
16623,5257,113117,7,9,2
16623,3943,106387,9,6,3
16625,26643,100258,9,7,2
16651,35449,109830,9,10,1
16661,32570,64115,8,8,0
16684,33390,107818,7,8,1
16684,8760,100263,7,8,1
16684,10186,106977,8,8,0
16684,34546,95801,8,8,0
16706,6595,107818,9,9,0
16706,13376,112442,7,6,1
16716,16579,102926,9,9,0
16716,23563,105695,9,10,1
16716,14674,112461,8,7,1
16716,11644,107818,9,7,2
16716,21278,97428,5,7,2
16716,21278,104257,7,8,1
16716,15525,108550,8,8,0
16716,32967,110148,5,9,4
16716,9283,98635,8,10,2
16716,9283,99371,4,1,3
16716,1378,112792,7,9,2
16716,29507,111149,6,9,3
16716,16336,113161,6,8,2
16716,10113,99951,8,8,0
16716,3367,109836,7,8,1
16733,28914,107048,9,7,2
16742,25404,93773,10,8,2
16749,11461,108052,9,10,1
16749,9145,109303,8,7,1
16778,20586,111503,7,8,1
16778,15251,109040,5,7,2
16779,27714,97576,9,10,1
16779,10514,87469,6,9,3
16779,11009,95765,9,8,1
16779,11510,95497,9,9,0
16790,30558,104694,9,8,1
16790,26872,112461,9,10,1
16790,17704,101889,9,7,2
16806,24545,113277,8,9,1
16806,28968,99685,9,10,1
16806,28968,102926,9,10,1
16806,28968,103064,9,10,1
16806,28968,110413,9,9,0
16806,28968,112641,9,8,1
16806,23678,91167,9,8,1
16806,23678,97165,9,9,0
16806,9006,99871,9,8,1
16806,12220,101258,8,7,1
16806,12220,107808,8,7,1
16806,4529,104797,7,9,2
16806,3903,93818,8,8,0
16806,16654,112579,8,9,1
16806,29723,95647,9,7,2
16806,31094,110005,9,9,0
16806,29321,106307,7,9,2
16806,2577,109424,8,8,0
16806,11009,92563,7,9,2
16806,24914,93640,8,7,1
16806,34849,111667,8,7,1
16806,32378,104466,8,7,1
16806,22075,91188,7,9,2
16806,3943,94924,7,7,0
16808,9537,96257,7,10,3
16903,16485,95953,8,7,1
16903,14498,79417,8,8,0
16903,7292,79522,8,8,0
16903,21883,87553,8,8,0
16903,21883,104348,8,3,5
16903,17801,86425,7,8,1
16903,32557,79470,8,8,0
16903,20084,113627,8,9,1
16903,18136,81283,8,9,1
16903,18788,91167,8,10,2
16903,11009,93223,8,8,0
16903,23678,104454,8,8,0
16903,19814,104756,8,7,1
16947,18193,112641,9,9,0
16969,4470,112864,8,8,0
16969,13801,113189,10,8,2
16969,33670,99685,9,10,1
16969,15251,108399,10,7,3
16969,15251,113277,8,8,0
16969,1353,108052,10,10,0
16969,34225,107688,10,6,4
16969,35176,97757,10,10,0
16969,35176,99423,7,9,2
16969,35176,113497,7,10,3
16969,10579,108255,4,8,4
16969,26902,112697,8,9,1
16969,13376,97493,10,8,2
16969,17704,107614,9,8,1
16969,12029,110006,7,9,2
17013,4623,110413,10,10,0
17074,27002,112573,9,10,1
17074,18136,112641,8,9,1
17074,7529,109506,10,10,0
17075,25404,89530,5,7,2
17075,25404,111282,4,7,3
17078,1355,110912,10,5,5
17078,7706,113497,4,7,3
17086,23650,110912,9,10,1
17086,32233,110413,9,9,0
17110,7607,112641,7,8,1
17110,24481,105323,7,9,2
17110,34225,107688,7,6,1
17110,31979,105665,7,7,0
17110,13648,108399,7,8,1
17110,27045,109759,5,6,1
17110,11009,104779,7,7,0
17110,20446,100486,6,9,3
17128,14436,111161,10,10,0
17128,34041,79116,6,6,0
17128,711,112471,9,9,0
17128,21952,110322,10,10,0
17128,18529,96895,2,8,6
17128,28450,104952,6,8,2
17141,25404,110413,10,10,0
17144,8969,105236,10,5,5
17165,34089,107048,8,9,1
17165,34089,112641,7,9,2
17165,24870,106856,8,8,0
17165,11770,92965,7,10,3
17165,15761,74486,7,9,2
17165,11009,100150,7,8,1
17165,11841,99703,6,6,0
17241,18878,110413,10,9,1
17241,13168,113277,9,10,1
17241,4494,112573,10,10,0
17252,3953,112573,10,10,0
17301,22862,101414,10,8,2
17301,15660,97814,9,9,0
17301,15660,106387,10,10,0
17310,2421,113277,8,10,2
17321,14498,99810,6,7,1
17321,4246,107211,6,5,1
17321,24118,86541,5,10,5
17326,33752,106856,7,6,1
17332,18296,109830,9,8,1
17332,4667,108550,10,9,1
17332,4667,113627,9,7,2
17353,34268,72890,8,10,2
17353,124,73486,9,7,2
17368,33924,106393,6,7,1
17368,4502,108308,5,5,0
17368,4502,109520,8,7,1
17368,26872,108238,6,8,2
17371,4973,112281,8,6,2
17415,28909,102685,10,7,3
17415,36058,101540,10,8,2
17415,4007,110632,9,9,0
17421,26566,110912,8,8,0
17439,1790,111161,10,9,1
17489,26075,113247,8,7,1
17510,5483,110413,6,10,4
17510,2842,110322,5,9,4
17510,25404,113409,2,7,5
17511,4755,107290,8,9,1
17519,4502,95016,8,9,1
17519,20098,110357,7,9,2
17519,26133,107290,8,9,1
17519,855,99674,7,6,1
17519,4667,94074,3,2,1
17519,4667,99423,7,8,1
17519,25359,112471,5,7,2
17519,25359,113189,7,8,1
17527,28786,113277,8,9,1
17527,23444,103064,10,7,3
17527,12364,94226,9,8,1
17527,12364,107207,5,9,4
17527,18136,106519,5,9,4
17527,25465,108550,5,8,3
17527,17800,92005,8,7,1
17527,17800,93779,5,8,3
17527,22848,93773,3,8,5
17527,25549,101765,5,9,4
17527,27909,98327,7,9,2
17527,23942,94721,5,10,5
17527,11009,111503,8,8,0
17527,26592,97441,5,6,1
17527,36058,110729,5,6,1
17535,13801,101272,7,4,3
17535,6579,103776,5,7,2
17571,8780,109830,9,7,2
17586,35574,46183,7,7,0
17590,21810,103644,7,7,0
17590,31157,99088,8,8,0
17590,4989,104714,9,8,1
17590,13236,111282,8,8,0
17592,35522,93870,8,9,1
17592,5101,96895,4,9,5
17593,7103,98258,10,9,1
17615,20446,59113,9,10,1
17624,17378,95016,10,8,2
17624,4316,101393,7,7,0
17624,3292,100814,9,7,2
17639,15163,75314,2,8,6
17639,3543,70849,5,6,1
17639,16806,61395,5,8,3
17639,34880,95497,8,7,1
17667,23563,99685,9,10,1
17667,23563,102926,8,9,1
17667,23563,108052,9,10,1
17667,23563,109830,9,7,2
17667,23563,110413,8,8,0
17667,19240,112471,8,9,1
17667,22286,96874,7,8,1
17667,28914,107048,8,7,1
17667,3909,104573,7,8,1
17667,12220,97165,10,7,3
17667,24511,97351,9,8,1
17667,17946,98627,7,8,1
17704,21238,111161,10,10,0
17704,33670,104431,7,7,0
17704,16175,113277,7,7,0
17704,14329,109445,8,8,0
17704,16969,107614,8,9,1
17704,16969,107688,9,10,1
17704,31519,108550,8,7,1
17704,26902,109506,7,10,3
17704,15877,112818,8,7,1
17704,33303,110005,7,10,3
17704,34849,112715,5,5,0
17704,25404,106598,6,7,1
17704,11009,110955,7,4,3
17714,16593,60748,10,10,0
17714,16593,65126,10,10,0
17724,12591,110475,10,10,0
17724,12591,112896,10,10,0
17724,26872,106701,10,4,6
17724,16282,103893,7,8,1
17747,12730,95953,5,9,4
17747,9883,93342,8,8,0
17747,9883,98532,7,7,0
17751,11073,109686,10,7,3
17751,2684,109506,10,7,3
17771,21082,81505,8,8,0
17796,18878,110413,8,9,1
17796,14326,99487,10,9,1
17800,23563,101507,7,9,2
17800,23563,102926,9,9,0
17800,7074,108399,7,9,2
17800,21240,106977,8,8,0
17800,2376,93779,8,10,2
17800,23977,104691,7,7,0
17800,36058,100802,7,2,5
17800,21082,100157,8,8,0
17800,36091,106697,8,6,2
17801,9283,104257,8,7,1
17801,9283,104694,9,10,1
17801,9283,104714,8,1,7
17801,9283,106918,8,7,1
17801,9283,107290,9,3,6
17801,9283,107818,8,10,2
17801,9283,108052,7,10,3
17801,9283,108160,8,10,2
17801,9283,110478,8,6,2
17801,9283,110912,9,4,5
17801,9283,112384,9,8,1
17801,9283,112864,8,3,5
17801,14498,111257,9,9,0
17801,19372,104431,8,7,1
17801,19372,106977,8,9,1
17801,19372,109830,9,10,1
17801,19372,110357,10,10,0
17801,4667,106582,7,8,1
17801,4667,109040,7,4,3
17801,4667,109444,8,5,3
17801,4667,111503,6,9,3
17801,4667,112281,9,4,5
17801,21278,111070,8,6,2
17801,32010,103776,8,5,3
17801,32010,106697,8,3,5
17801,32010,109686,8,7,1
17801,32010,112462,7,4,3
17801,26902,105695,9,10,1
17801,26902,110148,9,8,1
17801,26902,112641,8,10,2
17801,4502,107614,9,7,2
17801,4502,109813,7,6,1
17801,20294,103855,8,4,4
17801,20294,105793,7,2,5
17801,20294,110475,8,6,2
17801,20294,113497,9,3,6
17801,13376,103874,8,8,0
17801,13376,104389,8,7,1
17801,13376,105417,8,5,3
17801,13376,107211,7,5,2
17801,6579,107206,8,6,2
17801,35176,113189,8,10,2
17801,4302,112642,8,6,2
17801,30600,107798,9,6,3
17814,18304,90756,8,8,0
17814,18304,102926,9,8,1
17814,28138,79522,8,9,1
17814,15141,112641,9,9,0
17814,10538,84787,8,7,1
17814,3725,108052,9,10,1
17814,28914,86250,8,9,1
17844,5703,107048,7,8,1
17844,5703,109830,9,10,1
17844,2779,104431,7,10,3
17844,27094,110527,7,6,1
17854,4494,112573,9,10,1
17854,2439,109830,10,10,0
17854,19374,111495,7,9,2
17854,19240,111507,8,8,0
17879,11432,99423,10,10,0
17879,33752,99653,9,8,1
17879,28621,110475,8,7,1
17879,34880,91369,10,6,4
17882,27137,82096,5,6,1
17882,11009,64040,10,10,0
17894,16969,113189,8,10,2
17916,11599,99253,8,8,0
17916,11599,103956,5,6,1
17937,19010,71562,8,10,2
17937,24991,75686,8,7,1
17946,31490,110912,9,9,0
17946,34225,95705,8,6,2
17946,34225,105236,9,5,4
17946,34225,113277,9,10,1
17946,11382,105323,8,8,0
17946,35734,106519,9,7,2
17946,19033,100150,9,8,1
17946,23563,110357,7,10,3
17946,2684,109040,8,10,2
17946,28968,98273,9,7,2
17946,36097,97493,9,7,2
17946,15124,100944,7,8,1
17946,19892,98627,8,6,2
17953,1449,95765,10,10,0
17953,19814,84787,7,8,1
17963,27269,99674,2,8,6
17963,27751,110912,5,6,1
17963,191,111161,8,9,1
17963,21109,100502,3,5,2
17963,7073,107978,1,4,3
17969,775,110357,9,10,1
17969,25058,112641,9,8,1
17969,5991,95953,9,9,0
18022,20344,112573,10,9,1
18022,14316,112641,10,7,3
18022,25325,103064,7,8,1
18032,3758,95953,7,9,2
18032,15085,104797,8,7,1
18033,33457,110413,9,9,0
18033,25514,48424,9,6,3
18033,24481,113277,7,9,2
18052,6891,112573,8,10,2
18053,4193,113189,8,8,0
18053,13648,96874,5,5,0
18071,14592,93692,8,6,2
18071,32010,106697,7,3,4
18076,30013,112471,8,10,2
18076,15141,96283,8,9,1
18076,31979,81505,9,8,1
18077,34849,109444,9,7,2
18077,1430,101507,9,8,1
18077,4859,104684,9,7,2
18077,10579,108255,4,8,4
18077,11009,101410,9,8,1
18077,11009,102803,9,8,1
18079,4884,112471,7,8,1
18079,34565,75686,9,9,0
18083,24818,110912,9,10,1
18098,654,96874,8,8,0
18098,5754,110357,9,9,0
18098,9163,99088,7,7,0
18098,4242,102926,9,9,0
18098,19372,103639,8,9,1
18098,4973,98439,7,7,0
18098,26902,104691,9,10,1
18098,11009,99165,7,5,2
18102,4605,90605,8,9,1
18102,4605,107076,4,6,2
18102,13793,92991,7,8,1
18107,35357,97165,10,9,1
18107,14439,88247,10,10,0
18116,16556,106489,7,7,0
18116,16716,112461,8,8,0
18116,32570,110057,8,9,1
18123,26893,80678,6,9,3
18123,18984,95327,6,9,3
18123,4889,92067,6,8,2
18123,28914,82096,5,7,2
18123,19172,78718,5,9,4
18125,30256,103644,5,6,1
18125,31674,106918,6,6,0
18125,31674,107048,8,8,0
18136,30449,99674,9,7,2
18136,30449,106519,9,9,0
18136,22625,105236,9,8,1
18136,9467,102926,9,8,1
18136,17241,107207,9,9,0
18136,17241,112573,10,10,0
18136,14674,105695,9,9,0
18136,14674,109830,9,10,1
18136,9650,99685,9,10,1
18136,9650,112641,9,10,1
18136,21244,110932,9,9,0
18161,21728,107290,8,9,1
18173,29163,112641,10,9,1
18187,15251,110475,10,8,2
18193,16947,112641,9,9,0
18193,2534,111161,8,10,2
18193,2929,110912,8,10,2
18212,8920,102926,9,9,0
18235,3187,93779,7,7,0
18235,21370,113189,6,7,1
18235,11891,103939,8,9,1
18235,29896,113492,6,7,1
18235,33711,92272,5,7,2
18237,4884,113247,10,7,3
18248,1,113277,8,10,2
18248,191,110413,8,7,1
18256,5931,95271,6,6,0
18256,18596,106697,5,7,2
18256,28952,94737,7,8,1
18256,35926,109707,4,8,4
18256,3187,103776,6,7,1
18256,3187,111503,6,8,2
18257,15444,113492,7,5,2
18257,24477,111503,10,4,6
18257,28050,112740,7,9,2
18257,10579,104187,7,6,1
18266,133,86190,10,10,0
18270,20151,110632,7,6,1
18270,29760,110912,9,10,1
18275,12292,109830,10,9,1
18275,12292,110912,8,10,2
18275,12292,111161,10,10,0
18275,25058,105695,8,8,0
18304,31979,90605,8,9,1
18304,31979,90756,8,8,0
18304,31979,99685,8,9,1
18304,31979,105665,8,7,1
18304,34044,110413,9,10,1
18304,17814,102926,8,9,1
18304,33653,105236,9,8,1
18304,29079,89686,6,5,1
18304,28914,107048,7,7,0
18304,10652,91064,7,7,0
18304,11523,93629,7,6,1
18304,10802,106246,7,8,1
18335,2339,97981,6,7,1
18335,12587,101917,6,4,2
18335,12587,111686,8,4,4
18341,13252,105236,10,10,0
18341,8232,110912,10,10,0
18374,15968,88247,10,8,2
18374,15968,89013,4,7,3
18377,27751,110912,8,6,2
18377,11734,108052,9,8,1
18391,21278,103639,10,8,2
18398,12564,112471,6,7,1
18403,18596,95925,7,7,0
18411,14185,109830,9,8,1
18420,35510,110912,10,10,0
18420,20493,113277,9,9,0
18420,33571,106677,9,7,2
18420,16806,99871,10,9,1
18420,26902,97428,10,7,3
18420,3909,107554,5,9,4
18455,19950,112471,9,9,0
18455,1241,113247,7,8,1
18455,20446,105665,7,7,0
18459,24465,94226,8,9,1
18459,32378,104797,9,8,1
18501,30807,99674,6,9,3
18501,34849,111667,6,7,1
18524,19182,96928,9,7,2
18524,29760,111280,8,8,0
18529,16947,112641,9,9,0
18529,1790,110912,8,6,2
18529,26224,106489,8,7,1
18529,22856,103776,8,10,2
18529,23804,101410,9,7,2
18539,28272,99044,10,6,4
18549,11009,80408,7,8,1
18549,25521,79522,8,8,0
18549,32570,112817,8,7,1
18549,34565,109445,9,10,1
18572,711,112471,8,9,1
18575,12249,112471,7,10,3
18575,2337,113247,7,6,1
18596,24356,103873,10,5,5
18596,24356,107254,2,4,2
18596,5931,95271,8,6,2
18596,5931,97474,8,6,2
18596,24001,109830,10,5,5
18596,22434,103919,7,9,2
18596,13793,106697,7,8,1
18596,18403,95925,7,7,0
18634,5482,99871,10,9,1
18634,20586,111257,10,8,2
18634,29509,106965,8,6,2
18634,12903,113627,9,8,1
18672,27646,111161,10,9,1
18672,11749,102798,9,5,4
18672,7103,106308,6,8,2
18672,13376,96061,7,7,0
18674,29224,82398,10,6,4
18674,29224,97742,10,6,4
18674,2030,88847,10,10,0
18674,11599,78748,10,9,1
18674,11599,92099,10,9,1
18674,11599,93177,10,7,3
18674,18634,95897,10,6,4
18674,33670,100502,10,5,5
18674,35477,87910,10,6,4
18674,16969,112697,10,8,2
18674,18420,83658,10,8,2
18674,36016,102744,10,9,1
18674,36016,110167,10,8,2
18674,5598,108160,10,5,5
18674,5598,110099,10,6,4
18674,34880,92563,10,7,3
18674,10579,92991,10,9,1
18674,341,98384,10,6,4
18674,4246,85811,10,6,4
18674,13376,84827,10,8,2
18674,13376,103919,10,7,3
18674,24174,82377,10,7,3
18674,20446,101811,10,9,1
18674,20446,112966,10,9,1
18674,13492,96734,10,9,1
18674,11707,95294,10,5,5
18674,21883,106664,10,7,3
18674,17801,101587,10,8,2
18674,34849,81071,10,9,1
18689,628,112864,9,8,1
18692,35550,66740,6,7,1
18692,35550,70791,10,7,3
18696,22455,109254,6,8,2
18696,20849,105112,7,6,1
18696,31157,99810,5,9,4
18696,17801,109444,7,8,1
18705,1488,113277,8,9,1
18705,15801,112281,7,9,2
18705,20752,104348,8,9,1
18705,17800,108399,8,7,1
18705,17844,110527,7,7,0
18705,29760,112740,7,8,1
18705,26872,105812,7,8,1
18705,26872,112792,6,8,2
18705,13648,102059,7,8,1
18736,7629,107207,8,9,1
18736,24545,85794,3,8,5
18744,27817,89907,10,10,0
18758,25834,111161,10,10,0
18758,12292,110475,7,7,0
18758,7985,109117,10,9,1
18758,16623,86541,7,7,0
18759,16157,111161,10,9,1
18759,344,110912,10,10,0
18761,2827,112864,8,8,0
18776,29432,109830,10,9,1
18776,20779,111161,10,10,0
18785,27839,112864,9,8,1
18785,28050,112462,7,4,3
18785,35367,112851,9,6,3
18785,17801,109686,6,8,2
18785,11978,108147,6,7,1
18785,20684,108525,5,7,2
18785,35176,106701,6,9,3
18785,34849,111667,8,7,1
18785,6579,106611,9,5,4
18785,13801,109254,6,7,1
18785,26643,112602,4,6,2
18788,35734,76759,8,9,1
18788,11499,75860,8,7,1
18788,2532,94226,9,10,1
18788,15965,95715,9,7,2
18788,16903,91167,10,8,2
18788,30907,79550,5,3,2
18788,32183,74812,8,8,0
18796,1188,95583,7,7,0
18800,30094,111161,10,9,1
18800,9236,113277,10,8,2
18817,31305,113253,4,7,3
18817,13793,111686,7,8,1
18817,11009,89901,4,5,1
18847,30482,80684,9,10,1
18850,2508,95765,8,9,1
18850,5101,86190,8,9,1
18878,33847,105323,8,10,2
18878,28333,110413,9,8,1
18881,2439,111161,10,10,0
18881,25906,112573,9,10,1
18884,17489,96438,7,8,1
18884,22368,99785,8,7,1
18892,11891,100133,6,9,3
18916,5655,107808,9,9,0
18963,25550,60802,8,9,1
18963,11009,93223,7,8,1
18984,766,111161,9,10,1
18984,11506,110912,9,10,1
18987,5698,107120,10,8,2
19009,31480,112384,7,7,0
19009,4623,108550,6,10,4
19009,29319,113101,4,9,5
19010,221,99674,8,8,0
19010,4529,76759,8,9,1
19010,24672,93058,8,9,1
19012,15830,79944,10,10,0
19023,25549,107048,7,8,1
19033,14316,112641,9,7,2
19033,15163,110632,9,8,1
19033,14329,109445,8,8,0
19033,34429,113101,7,5,2
19033,32233,112950,8,8,0
19066,32646,93870,9,7,2
19066,17510,110413,9,6,3
19066,27487,103064,9,8,1
19084,1763,110912,8,9,1
19084,5483,110413,10,10,0
19101,1799,111161,10,10,0
19101,22368,109445,9,6,3
19103,9006,107207,10,10,0
19127,32648,110413,10,8,2
19127,12220,95327,9,8,1
19127,12220,99077,7,8,1
19127,31925,105665,6,7,1
19127,27909,101829,7,7,0
19127,27909,109424,8,9,1
19127,15660,107822,6,5,1
19127,34449,87803,7,6,1
19127,28142,103767,10,7,3
19127,15830,107653,9,9,0
19127,11009,95250,7,8,1
19127,29079,97162,6,6,0
19127,7103,92618,6,8,2
19168,10835,112471,8,8,0
19172,18123,78718,9,5,4
19182,13394,112573,10,10,0
19182,7868,112682,7,8,1
19182,21261,112896,5,8,3
19182,15124,113497,4,8,4
19182,29841,113627,9,8,1
19182,7790,104952,8,8,0
19182,23215,109951,5,8,3
19185,6891,107290,10,10,0
19185,20546,113481,7,7,0
19185,1790,111161,10,9,1
19185,21238,107048,7,8,1
19185,31157,112864,9,7,2
19185,22286,112641,10,8,2
19185,11081,113492,7,6,1
19185,30667,108399,8,10,2
19240,23563,108052,10,10,0
19240,23563,109830,10,7,3
19240,23563,110912,9,10,1
19240,17667,112471,9,8,1
19240,12292,105323,10,10,0
19240,28968,112384,7,10,3
19240,17854,108394,9,7,2
19240,17854,111495,9,7,2
19240,17854,111507,8,8,0
19250,27094,86250,10,9,1
19250,6764,84787,8,8,0
19250,18304,105236,9,9,0
19250,13461,95765,9,9,0
19250,6579,87800,7,5,2
19250,8978,107818,8,7,1
19250,9455,103919,6,8,2
19250,31305,84516,7,9,2
19250,34044,112817,7,10,3
19252,30116,107290,10,8,2
19252,13059,102945,10,5,5
19259,31674,107048,6,8,2
19259,14326,112384,7,8,1
19259,23215,96734,6,5,1
19260,21221,107207,10,9,1
19260,19240,75686,9,8,1
19260,27909,101410,8,9,1
19261,10652,97165,8,7,1
19261,17128,61735,8,8,0
19262,19084,110413,8,10,2
19262,11603,89218,7,8,1
19262,28914,105695,7,8,1
19262,1449,98635,7,6,1
19262,29760,95705,9,7,2
19262,9283,96438,8,7,1
19262,14228,97428,7,7,0
19262,14436,105415,10,7,3
19262,13376,107978,1,6,5
19271,27909,108394,9,10,1
19271,27909,111507,9,8,1
19300,25325,103064,10,8,2
19300,30807,95705,10,7,3
19351,28839,107048,6,8,2
19351,9236,110413,7,10,3
19351,853,97937,7,10,3
19351,29163,106677,8,7,1
19351,19009,108550,7,6,1
19351,3543,109424,9,5,4
19372,32112,109830,10,9,1
19372,22286,104431,7,7,0
19372,5754,110357,10,9,1
19372,7108,106977,9,9,0
19372,35176,107131,8,10,2
19429,474,105695,7,9,2
19429,27957,103939,7,7,0
19429,17800,108399,8,7,1
19429,17527,106519,8,5,3
19429,2680,110632,6,9,3
19429,33878,106664,7,5,2
19429,13376,110678,5,7,2
19429,7790,100814,7,8,1
19439,8944,108052,3,10,7
19439,7108,63522,1,8,7
19446,4137,95953,8,10,2
19446,25964,97576,9,9,0
19446,14286,96256,8,8,0
19446,4667,102685,9,8,1
19446,2867,107076,7,8,1
19446,17801,96438,8,9,1
19446,34849,98554,7,8,1
19446,29108,113568,8,9,1
19446,6414,97815,8,10,2
19467,26630,110413,8,8,0
19467,1,113277,9,10,1
19467,22368,104257,8,6,2
19475,28182,109190,7,5,2
19478,13376,98554,9,7,2
19478,13376,112442,8,6,2
19493,5195,113409,8,8,0
19535,8983,102536,8,9,1
19535,8050,92991,2,7,5
19535,31979,101761,10,7,3
19581,13014,113247,7,10,3
19588,24897,112471,9,6,3
19611,20849,100029,6,7,1
19611,15715,107290,7,10,3
19611,10579,95016,10,9,1
19611,23913,97659,7,8,1
19611,9537,108037,9,10,1
19611,2867,107076,7,8,1
19621,13376,100157,8,9,1
19653,32597,44081,8,8,0
19668,7447,111161,10,10,0
19675,4095,86637,9,10,1
19675,4095,89853,8,7,1
19675,10365,94663,7,10,3
19675,27909,86979,9,8,1
19682,1057,111161,8,10,2
19682,25906,112573,8,10,2
19682,30239,103064,9,8,1
19695,133,86190,8,10,2
19695,4667,86393,4,3,1
19751,1888,50083,10,10,0
19751,2680,54215,10,9,1
19778,22628,64665,8,8,0
19811,26325,111161,10,10,0
19814,18256,109707,9,4,5
19814,8038,108122,9,8,1
19814,16903,104756,7,8,1
19814,8606,103767,10,9,1
19814,13376,105275,7,7,0
19814,34849,105226,9,8,1
19814,34849,109506,8,10,2
19814,17415,110632,9,9,0
19814,32495,105151,9,10,1
19814,25404,105046,8,7,1
19814,8050,100935,7,10,3
19814,23678,100681,9,9,0
19829,2841,111161,10,10,0
19829,9163,99088,7,7,0
19829,30652,102926,8,7,1
19844,27156,111161,8,10,2
19844,14295,109830,9,10,1
19844,12903,113627,7,8,1
19870,25735,91777,8,5,3
19870,24041,107614,7,8,1
19870,32817,93756,2,6,4
19870,32817,98105,9,5,4
19876,1057,109830,10,8,2
19885,3943,94315,9,8,1
19885,17800,92005,8,7,1
19885,27094,59245,8,10,2
19892,26063,105236,9,8,1
19892,15444,104868,8,6,2
19892,17704,109506,7,7,0
19892,16048,102494,6,7,1
19892,17946,98627,6,8,2
19892,34849,111003,6,6,0
19892,35469,94886,6,7,1
19909,18689,102926,8,10,2
19919,29524,110912,8,10,2
19927,33665,112573,7,10,3
19927,24605,111161,5,8,3
19927,17013,110413,8,10,2
19931,31390,102034,10,4,6
19931,4667,111301,10,1,9
19931,10579,106761,10,5,5
19943,133,86190,6,10,4
19949,21168,104694,7,8,1
19949,22856,99422,7,4,3
19949,22856,106453,4,1,3
19950,18455,112471,9,9,0
19950,9702,111495,8,10,2
19950,9702,111507,8,8,0
19967,30013,94291,8,7,1
19967,16214,88258,9,7,2
19967,22400,95953,7,10,3
19988,26902,89175,6,8,2
20040,25426,112462,5,6,1
20047,32771,112442,8,10,2
20047,25399,97493,7,7,0
20050,30518,95016,10,9,1
20050,7108,109506,10,7,3
20050,21728,104797,10,10,0
20062,2439,102926,10,10,0
20062,22090,79470,10,6,4
20062,13021,113101,8,10,2
20062,16623,105812,6,7,1
20081,10528,108330,7,6,1
20081,1488,107207,10,10,0
20084,28968,90605,9,10,1
20084,28968,100168,8,7,1
20084,27487,93773,7,7,0
20084,14157,94625,8,7,1
20084,4667,111503,8,9,1
20084,4667,113627,9,7,2
20084,21278,91763,9,8,1
20084,21278,94898,8,7,1
20084,30905,100802,7,7,0
20084,5919,91939,8,5,3
20084,16969,97216,10,10,0
20084,4529,104797,10,9,1
20084,20294,97441,10,7,3
20084,26352,105812,7,8,1
20094,25361,93779,8,10,2
20094,35477,93378,8,6,2
20098,22286,109830,6,9,3
20098,18248,113277,9,8,1
20098,30691,110357,9,10,1
20106,14630,107207,9,10,1
20106,14630,109830,7,10,3
20106,14630,112573,9,10,1
20106,11461,108052,9,10,1
20106,11461,110912,9,10,1
20106,2439,111161,9,10,1
20106,24277,112641,10,10,0
20106,33640,112818,5,8,3
20106,21240,106977,8,8,0
20145,7213,100802,7,8,1
20145,27453,112281,7,8,1
20145,16015,104652,6,7,1
20145,4973,109040,7,10,3
20145,1411,100403,5,9,4
20145,11432,102685,6,4,2
20151,10337,89880,5,10,5
20151,26621,100814,9,10,1
20151,18270,110632,6,7,1
20151,35080,94074,1,5,4
20151,35312,95179,2,3,1
20151,35312,97388,3,1,2
20151,17704,93177,7,2,5
20169,14599,94226,9,7,2
20169,2731,71360,8,7,1
20185,25878,98382,5,10,5
20185,25878,102975,5,10,5
20195,3292,106582,7,7,0
20195,8488,109506,6,9,3
20195,34849,112715,6,5,1
20195,13376,103919,5,7,2
20195,957,109045,8,7,1
20195,22090,112760,8,5,3
20208,26712,93870,7,7,0
20208,5534,104348,7,10,3
20215,27116,97165,8,10,2
20221,12730,111161,8,10,2
20221,13252,105236,8,10,2
20227,20145,93773,10,7,3
20277,29158,112346,7,7,0
20277,35477,112740,7,7,0
20281,25101,100507,10,6,4
20281,2120,112471,9,9,0
20281,26463,105236,9,8,1
20281,13739,107207,10,10,0
20281,341,107034,8,8,0
20294,775,110357,7,10,3
20294,35121,105236,9,5,4
20294,25058,105695,9,8,1
20294,25058,110322,7,8,1
20294,25058,112641,7,8,1
20294,16250,107048,6,10,4
20294,16250,108358,9,10,1
20294,34060,107207,9,10,1
20294,17801,103772,7,6,1
20294,17801,103855,4,8,4
20294,17801,105793,2,7,5
20294,17801,110475,6,8,2
20294,17801,113497,3,9,6
20294,4667,104691,7,6,1
20294,9490,106611,5,8,3
20299,19023,107048,10,7,3
20344,12864,111161,9,10,1
20344,25950,112573,9,8,1
20345,133,86190,7,10,3
20346,35574,113497,7,9,2
20346,2867,107614,8,9,1
20346,34849,84917,8,10,2
20355,9982,85407,7,10,3
20355,2867,106308,7,9,2
20356,18878,105323,8,8,0
20356,24760,109830,10,9,1
20356,9413,111282,7,9,2
20356,23215,98084,6,7,1
20356,23215,109444,7,7,0
20356,3905,95652,8,7,1
20356,7706,102138,8,8,0
20389,10526,111257,5,1,4
20389,18776,109830,10,10,0
20389,24481,109686,6,7,1
20400,1045,110622,3,7,4
20400,10318,113492,4,6,2
20400,13376,99810,6,8,2
20400,13376,112722,5,6,1
20400,24991,101410,7,7,0
20400,10579,110475,6,7,1
20400,20507,107969,6,6,0
20400,30907,112760,3,1,2
20424,12220,107818,7,8,1
20428,18878,105323,9,8,1
20428,10186,107818,7,8,1
20428,27534,99348,8,9,1
20430,16616,105236,8,6,2
20430,26352,105812,6,8,2
20430,3943,106387,6,6,0
20430,13492,107050,7,8,1
20433,31979,81505,8,8,0
20433,33653,66921,9,8,1
20433,8050,56085,6,8,2
20446,29224,90264,6,8,2
20446,29224,97742,5,6,1
20446,35574,103776,7,8,1
20446,10579,87469,9,7,2
20446,33670,97937,9,7,2
20446,3187,93779,10,7,3
20446,17801,97165,10,8,2
20446,15715,91217,9,10,1
20446,17800,91474,9,7,2
20446,17800,100157,9,8,1
20446,17800,104691,9,7,2
20446,9413,93058,9,10,1
20446,9413,108550,9,9,0
20446,13376,87892,10,7,3
20446,13376,88172,9,8,1
20446,13376,89360,8,7,1
20446,13376,95159,9,7,2
20446,13376,103919,7,7,0
20446,13376,111149,9,9,0
20446,15644,92563,9,9,0
20446,15644,95270,8,7,1
20446,30998,90756,10,9,1
20446,30998,101669,8,7,1
20446,29349,90966,8,9,1
20446,8050,86979,9,8,1
20446,8050,88846,10,9,1
20446,8050,104029,9,8,1
20446,25404,104036,10,6,4
20446,11009,86984,8,7,1
20446,11009,93818,8,8,0
20446,11009,101889,10,7,3
20446,11009,105217,6,5,1
20446,11510,95497,10,9,1
20446,27045,87538,8,6,2
20446,27045,101921,9,8,1
20446,20901,109635,5,7,2
20446,16806,91167,10,9,1
20446,16806,93640,8,8,0
20446,16806,95647,9,9,0
20446,2867,98213,8,9,1
20446,31613,94608,9,8,1
20446,18455,105665,7,7,0
20446,25658,99077,9,8,1
20446,4246,110308,8,7,1
20446,13648,100318,8,6,2
20446,33014,108071,9,6,3
20446,4302,90583,6,6,0
20446,21883,105428,5,4,1
20446,9283,97322,8,8,0
20446,9283,110428,10,6,4
20446,1610,89424,9,10,1
20446,10018,106881,8,9,1
20446,16903,104454,10,8,2
20446,3903,108101,10,8,2
20446,35091,105151,9,10,1
20446,27909,89841,9,7,2
20446,20430,94142,8,6,2
20446,19814,87233,7,5,2
20446,11707,101798,8,4,4
20446,29595,88987,9,7,2
20446,29158,91554,6,7,1
20446,18674,101811,9,10,1
20446,18674,112966,9,10,1
20446,12239,93776,9,9,0
20446,32570,88275,10,9,1
20446,29319,100054,8,7,1
20446,26902,94332,8,7,1
20446,10133,113464,8,8,0
20446,33711,90319,7,6,1
20446,3943,91578,9,7,2
20446,17110,100486,9,6,3
20446,35750,88178,9,8,1
20464,34849,101786,6,6,0
20469,3580,112864,8,6,2
20469,16175,113277,7,7,0
20469,11599,109506,9,9,0
20469,18256,109707,7,4,3
20469,7103,108037,1,9,8
20469,7790,110123,5,3,2
20469,35469,112922,7,7,0
20473,17704,108550,8,8,0
20493,28786,113277,9,9,0
20493,16476,112641,9,8,1
20507,28700,113189,8,7,1
20507,23563,110357,8,10,2
20507,19429,103939,7,7,0
20507,4246,109635,5,6,1
20507,13648,107206,8,5,3
20507,20688,107969,6,6,0
20515,2788,110912,10,9,1
20515,29841,105236,10,8,2
20515,17590,111282,8,8,0
20517,10579,103064,9,8,1
20531,4246,71315,9,6,3
20533,28537,96256,6,10,4
20533,26902,109506,6,10,4
20533,32591,113409,4,10,6
20533,13376,100802,7,9,2
20533,12587,104029,7,6,1
20536,4605,90605,10,9,1
20543,2680,92965,7,8,1
20543,32495,108330,7,8,1
20545,18785,97576,10,10,0
20545,33402,93773,10,7,3
20546,14926,106308,10,8,2
20546,15124,113481,7,4,3
20546,19372,99088,10,10,0
20546,7213,100802,10,8,2
20546,29629,103064,10,9,1
20546,12903,111282,8,7,1
20579,6579,105417,10,6,4
20579,6579,109830,1,10,9
20586,16778,111503,8,7,1
20586,6579,105112,7,6,1
20586,12928,111257,8,8,0
20649,3344,112471,9,8,1
20649,13657,108052,10,9,1
20649,19324,95953,8,9,1
20649,15963,86066,5,8,3
20649,27307,88247,9,10,1
20649,23913,103064,10,7,3
20680,1916,95953,9,7,2
20680,1449,112851,10,6,4
20684,19829,102926,10,8,2
20684,18785,102057,8,9,1
20684,18785,103776,9,8,1
20684,18785,108525,7,5,2
20684,18785,109686,7,6,1
20684,18785,112462,5,7,2
20684,8232,109830,9,9,0
20684,34404,103064,10,8,2
20684,30807,102510,7,6,1
20684,13236,97958,8,8,0
20684,6579,105112,7,6,1
20684,6579,113161,6,8,2
20684,19185,107290,8,10,2
20684,9932,110475,6,7,1
20684,26902,100258,7,7,0
20684,30600,99253,6,7,1
20684,26808,100507,4,7,3
20684,13376,100502,6,9,3
20684,13376,113253,5,6,1
20684,17801,105793,8,7,1
20684,25573,98282,8,10,2
20684,23913,99472,6,7,1
20688,9843,109831,8,6,2
20688,25404,93779,9,10,1
20688,20507,107969,6,6,0
20688,17801,113497,7,9,2
20689,7103,107808,8,8,0
20700,35503,99685,8,9,1
20700,19300,103064,8,10,2
20700,13657,106519,6,7,1
20700,26808,110413,8,9,1
20700,11978,102975,8,9,1
20700,11978,111280,7,6,1
20700,11073,106977,8,7,1
20700,35574,96895,8,8,0
20700,35574,103776,7,8,1
20700,35574,112462,6,1,5
20700,4667,111257,6,9,3
20700,4667,113277,9,9,0
20700,34429,97733,7,7,0
20700,34164,107387,6,3,3
20700,957,99951,7,6,1
20700,30558,96446,8,3,5
20713,22744,86034,7,7,0
20713,8164,102494,7,7,0
20713,11081,112864,8,8,0
20713,11478,93058,9,7,2
20713,18455,112471,8,9,1
20713,19185,83658,8,10,2
20713,10384,81505,8,6,2
20713,30998,108394,8,6,2
20713,23678,88939,8,9,1
20713,6925,95468,8,7,1
20713,7103,111507,8,8,0
20713,24897,83922,7,6,1
20713,2799,95631,8,7,1
20713,11841,86425,7,6,1
20713,27909,109688,8,9,1
20747,27817,80431,5,5,0
20747,27817,82933,5,5,0
20752,19324,95953,9,9,0
20752,35710,104348,9,5,4
20752,26224,106489,7,7,0
20760,3197,68646,9,10,1
20760,555,111161,10,10,0
20770,33095,107290,9,7,2
20770,32597,81505,10,7,3
20775,19811,111161,10,10,0
20775,26051,113277,8,9,1
20779,21411,111161,10,9,1
20792,10495,71562,10,10,0
20792,25465,99674,7,9,2
20798,12220,110912,8,8,0
20818,26902,94332,6,7,1
20849,22852,105236,7,7,0
20849,18696,105112,6,7,1
20849,16476,106918,6,8,2
20857,19240,111495,10,9,1
20857,19240,111507,9,8,1
20860,15381,70047,9,10,1
20860,13793,110632,9,9,0
20860,20446,87469,9,9,0
20866,24870,82096,8,9,1
20866,11009,84855,9,9,0
20866,11009,104348,9,10,1
20866,2870,89114,7,6,1
20877,9702,70511,7,9,2
20877,27412,97223,7,10,3
20877,15163,97165,7,9,2
20877,27909,83922,9,10,1
20877,35477,77269,7,8,1
20896,28669,62229,8,10,2
20901,7679,103776,7,8,1
20901,8532,112384,8,8,0
20901,30760,107048,8,8,0
20901,30760,111756,6,8,2
20901,27045,104348,9,8,1
20901,11009,106677,8,9,1
20901,11009,106918,7,7,0
20901,11009,110074,7,7,0
20901,11009,110413,9,8,1
20901,11009,110771,6,6,0
20901,11009,113161,9,9,0
20901,23293,104694,7,9,2
20901,2731,107818,8,7,1
20901,18705,112740,7,7,0
20901,23647,111742,6,7,1
20901,16556,104257,7,9,2
20901,9283,103772,7,8,1
20901,9283,106856,8,9,1
20901,9283,109635,7,7,0
20901,13376,111257,7,8,1
20901,17801,107798,7,9,2
20901,6579,103241,8,8,0
20901,16716,112461,8,8,0
20901,3640,104427,7,7,0
20901,31408,107473,6,7,1
20901,2547,108238,6,6,0
20901,2345,112819,6,7,1
20901,16623,112346,8,9,1
20901,28159,104438,5,7,2
20901,5919,107889,7,7,0
20921,6155,93779,7,10,3
20929,35121,105236,9,5,4
20929,21739,110912,10,10,0
20929,25359,112471,9,7,2
20937,17854,108394,9,7,2
20937,17854,111495,8,7,1
20937,17854,111507,10,8,2
20937,22594,100157,8,8,0
20937,28858,93058,9,8,1
20937,8701,93191,8,9,1
20937,4723,92651,7,8,1
20955,6579,100405,7,5,2
20955,9976,102926,9,10,1
20958,27816,73802,9,9,0
20973,221,99674,8,8,0
21006,26872,91042,10,4,6
21023,8162,110912,9,9,0
21023,16225,107048,6,8,2
21023,25549,101765,10,9,1
21037,31460,90605,6,8,2
21037,27314,81505,7,10,3
21037,46,91167,6,8,2
21047,40,109830,10,8,2
21072,15840,108052,9,10,1
21072,32183,102926,9,9,0
21072,7706,86637,8,8,0
21074,9455,103919,4,8,4
21074,25404,93437,6,6,0
21082,34225,102926,7,7,0
21082,34225,109830,9,10,1
21082,34225,110912,8,10,2
21082,34225,111161,9,10,1
21082,18944,100157,8,8,0
21109,1839,100502,5,5,0
21109,1449,113568,5,9,4
21119,19507,109830,10,9,1
21126,11009,54047,10,6,4
21143,19310,112471,7,9,2
21143,29760,110148,8,7,1
21143,5675,102138,8,9,1
21143,8983,102536,7,9,2
21149,29313,110413,9,8,1
21149,11009,97027,7,8,1
21150,29275,113277,5,1,4
21150,14316,112641,8,7,1
21177,20901,91419,5,6,1
21182,10823,107290,7,9,2
21196,18667,109830,10,8,2
21196,36087,106220,10,10,0
21224,13252,102138,9,8,1
21230,32597,100234,10,10,0
21230,827,73312,7,8,1
21230,827,101410,8,9,1
21230,32570,82085,8,9,1
21230,32570,88184,7,7,0
21230,32570,101318,8,7,1
21230,29158,109348,9,8,1
21230,25549,67185,8,8,0
21230,31934,71141,7,9,2
21230,12996,94011,7,8,1
21230,11510,99365,5,5,0
21230,4723,92651,8,8,0
21230,27909,98327,8,9,1
21230,22900,105378,7,8,1
21230,13648,96163,7,5,2
21230,35469,76574,8,7,1
21230,35469,107034,6,7,1
21238,32442,111161,10,9,1
21238,31674,107048,8,8,0
21238,33212,109686,7,9,2
21240,31490,110912,8,9,1
21240,34225,102926,10,7,3
21240,15163,107818,9,8,1
21240,9005,99674,8,1,7
21240,17800,106977,8,8,0
21261,2434,97937,8,9,1
21261,29723,106677,8,6,2
21261,19182,112896,8,5,3
21261,16282,102492,7,10,3
21267,7103,93191,9,10,1
21274,32597,108122,8,8,0
21274,7103,107822,9,9,0
21274,7103,112384,7,7,0
21278,29035,100507,4,8,4
21278,11159,105236,9,10,1
21278,13061,103064,9,10,1
21278,17801,97428,7,8,1
21278,17801,103639,8,9,1
21278,17801,104257,8,8,0
21278,17801,109830,9,9,0
21278,17801,111070,6,8,2
21278,18705,108399,8,8,0
21278,18705,110527,7,7,0
21320,133,86190,6,10,4
21347,1057,111161,10,10,0
21358,23394,70735,9,10,1
21358,35091,101410,10,10,0
21358,11009,67541,8,8,0
21364,16092,99685,8,10,2
21364,2684,103776,8,10,2
21364,2684,112462,5,10,5
21370,18572,112471,6,8,2
21370,9911,107614,7,7,0
21370,31408,110413,8,6,2
21370,9932,110475,7,7,0
21370,2739,112442,7,8,1
21370,17801,113189,7,8,1
21402,1490,109830,10,8,2
21402,28450,86879,10,9,1
21402,18098,104691,9,9,0
21411,17852,112573,9,9,0
21411,12786,113277,7,7,0
21422,27839,112864,8,8,0
21456,8623,99674,10,7,3
21456,33726,86250,10,10,0
21456,14782,96764,7,6,1
21456,21703,88846,9,8,1
21456,11009,84855,9,9,0
21456,32597,112445,9,8,1
21495,9283,107822,7,10,3
21519,26133,107290,8,9,1
21519,14286,96256,8,8,0
21519,34849,90728,7,10,3
21540,22953,93748,10,10,0
21604,12903,111282,5,7,2
21605,13376,92005,8,10,2
21608,25549,103939,7,6,1
21608,25549,112471,7,9,2
21610,24770,110413,9,9,0
21616,35469,109045,7,7,0
21627,27888,71562,10,8,2
21629,7911,107290,8,9,1
21629,7911,107808,8,7,1
21629,24870,106856,6,8,2
21629,4605,106977,8,10,2
21646,7054,97958,10,10,0
21646,29841,113627,9,8,1
21692,24001,108550,10,2,8
21703,2577,74958,8,10,2
21703,20921,93779,9,7,2
21703,28968,88846,8,8,0
21703,33571,101410,6,8,2
21703,11009,94663,7,7,0
21703,6579,107507,8,8,0
21706,23798,100157,9,8,1
21715,10579,106697,9,8,1
21718,4816,111161,9,10,1
21728,5971,97165,10,9,1
21728,53,110912,10,10,0
21728,13617,96283,8,9,1
21728,34565,112641,10,8,2
21728,28450,97814,8,8,0
21728,27002,112573,10,10,0
21728,12220,107290,9,8,1
21728,24545,104652,8,8,0
21728,34341,104797,10,10,0
21728,9702,107943,8,8,0
21730,766,111161,9,10,1
21739,20098,99685,9,8,1
21739,3844,110912,10,7,3
21740,23330,68646,10,8,2
21740,8701,69704,10,10,0
21744,33665,112573,9,10,1
21744,12514,111161,9,8,1
21744,18254,112471,8,8,0
21754,5597,84516,8,8,0
21755,4667,112864,10,9,1
21760,27534,110632,7,8,1
21778,10734,109830,9,8,1
21778,21196,106220,9,10,1
21778,11936,112697,9,8,1
21785,22953,102266,10,6,4
21785,6414,107286,10,7,3
21790,28138,105643,1,1,0
21798,33544,105323,10,9,1
21798,16250,113277,10,10,0
21810,17590,103644,7,7,0
21810,32148,102057,10,8,2
21863,34793,108052,9,9,0
21863,15904,111161,9,10,1
21871,21370,97659,6,5,1
21883,28914,110413,9,9,0
21883,28914,113277,10,8,2
21883,32557,110912,10,10,0
21883,4884,108399,9,7,2
21883,28363,99785,10,6,4
21883,24277,109707,6,7,1
21883,36058,104348,3,3,0
21883,23215,105112,9,8,1
21883,20901,113161,8,9,1
21883,3187,104431,10,9,1
21883,25404,99871,7,8,1
21883,30648,113497,9,7,2
21883,10579,112499,3,6,3
21883,7706,103919,8,3,5
21883,7706,106664,7,5,2
21883,6168,107666,8,8,0
21883,7946,110997,9,8,1
21883,20446,105428,4,5,1
21884,10579,110364,8,8,0
21891,14926,106308,10,8,2
21908,22740,111161,9,10,1
21908,21863,108052,7,9,2
21908,21739,110912,9,10,1
21908,34449,110413,6,8,2
21908,23245,112851,1,7,6
21939,7790,113419,10,6,4
21939,17801,113497,10,9,1
21939,2772,107120,10,8,2
21952,4623,110322,10,10,0
21956,28702,99487,7,8,1
21956,19009,108550,10,6,4
21961,14447,97239,8,5,3
21961,23164,78748,8,9,1
21961,18098,62622,10,8,2
21974,11599,103874,7,7,0
21974,18136,110932,8,9,1
21974,9283,96438,7,7,0
21974,9283,105265,8,10,2
21974,11009,94747,7,9,2
21988,19185,99785,9,8,1
21988,33792,104348,8,7,1
21988,13301,95953,9,9,0
21988,28968,107473,8,6,2
22028,25865,111161,8,9,1
22028,17086,110413,9,9,0
22028,9455,97981,4,6,2
22028,9455,98084,5,7,2
22028,12903,96071,8,7,1
22028,11009,103035,5,5,0
22037,13572,93748,8,8,0
22037,35176,103786,7,6,1
22037,25735,100114,6,6,0
22043,14439,62622,9,10,1
22056,17800,81398,9,6,3
22056,34565,111495,9,10,1
22064,4362,107207,10,8,2
22064,15516,104694,9,10,1
22066,4808,101410,9,8,1
22075,14579,107131,8,9,1
22075,6890,107688,9,10,1
22075,27184,112384,8,7,1
22075,35176,112453,7,10,3
22075,3292,104070,9,7,2
22075,16806,112579,9,8,1
22075,28337,101698,9,8,1
22075,21883,110997,9,9,0
22089,15715,94226,8,7,1
22089,20688,107969,5,6,1
22090,7616,106611,6,7,1
22090,33456,102511,7,8,1
22090,18705,104348,7,8,1
22090,3673,99385,5,7,2
22090,11009,110955,7,4,3
22090,29582,105121,6,7,1
22090,6380,98471,6,6,0
22090,3909,104573,7,8,1
22090,20195,112760,5,8,3
22090,34849,102603,7,6,1
22229,9293,93191,10,10,0
22229,23533,107822,8,9,1
22234,22900,91763,9,9,0
22234,18123,95327,10,6,4
22241,29035,89927,10,10,0
22241,32010,109040,10,9,1
22241,32010,112281,10,8,2
22253,15604,110912,9,10,1
22256,34880,96283,9,8,1
22267,28669,106307,8,7,1
22286,21739,110912,8,10,2
22286,20098,109830,9,6,3
22286,2677,112641,8,9,1
22286,19372,104431,7,7,0
22299,2677,112641,4,9,5
22299,3892,112384,10,6,4
22312,191,110413,10,7,3
22312,18022,112641,10,10,0
22312,23563,107554,9,8,1
22324,20195,91790,4,8,4
22324,1916,90305,4,6,2
22324,10579,91419,8,7,1
22368,24760,109830,9,9,0
22368,1763,106856,7,8,1
22368,1763,111161,8,10,2
22368,6456,107290,8,9,1
22368,34277,112818,7,7,0
22368,26352,109445,6,8,2
22368,33670,104940,7,7,0
22400,7851,102926,9,7,2
22400,7851,108052,9,9,0
22400,7851,109830,10,7,3
22400,24277,104257,8,7,1
22404,1289,56869,7,6,1
22404,12786,95016,7,5,2
22423,33435,97937,9,7,2
22423,16214,96874,7,8,1
22423,15397,99088,6,8,2
22423,2574,106677,8,8,0
22423,9455,110148,7,9,2
22434,15381,87800,9,7,2
22434,35276,94862,8,5,3
22434,26902,103919,9,8,1
22455,32771,109830,8,9,1
22455,18696,109254,8,6,2
22455,3292,107290,10,10,0
22457,36139,84726,6,10,4
22457,14139,104348,8,10,2
22457,4246,110527,6,8,2
22464,2779,104431,8,10,2
22464,35176,107131,7,10,3
22464,10579,104940,10,9,1
22468,549,110912,6,8,2
22468,7447,111161,10,10,0
22471,15199,109830,9,9,0
22471,23390,111161,10,8,2
22471,4137,105236,8,9,1
22475,13928,75314,8,9,1
22475,1372,71877,6,8,2
22499,8532,112471,10,7,3
22499,14516,98724,9,8,1
22499,17844,97165,7,8,1
22499,20901,113161,9,9,0
22502,12753,107290,7,10,3
22502,280,112864,7,9,2
22502,5963,110912,10,10,0
22502,28130,109445,8,7,1
22502,4667,111161,9,10,1
22519,12364,111507,6,7,1
22532,14316,99685,10,8,2
22532,13657,108052,10,9,1
22565,32532,106364,7,10,3
22594,31617,105236,8,7,1
22594,31617,108052,8,10,2
22594,20446,104454,7,10,3
22619,8643,111161,10,9,1
22619,17421,110912,7,8,1
22625,32797,97165,4,8,4
22625,4472,105236,8,9,1
22628,15723,104348,8,9,1
22628,35272,96446,5,8,3
22628,24654,105323,4,9,5
22628,7529,96754,5,10,5
22628,7529,111503,6,6,0
22628,27045,97737,4,5,1
22628,26621,100814,5,10,5
22628,5709,96895,8,6,2
22628,11009,102943,6,5,1
22628,30600,99253,4,7,3
22628,2867,94862,6,9,3
22628,31613,104181,3,6,3
22628,28791,110917,9,8,1
22628,27817,95904,5,6,1
22643,28858,93058,6,8,2
22643,17667,87182,10,6,4
22685,11419,110413,8,3,5
22729,12572,110877,8,8,0
22740,15904,99685,10,9,1
22740,15904,111161,10,10,0
22742,12730,112471,7,9,2
22744,29224,90264,8,8,0
22744,29224,93428,7,6,1
22744,29224,97742,6,6,0
22744,29224,113189,8,7,1
22759,13801,87182,7,4,3
22759,7108,85333,8,8,0
22759,1617,112641,8,7,1
22759,3372,109707,7,8,1
22759,9145,86397,7,7,0
22759,34849,102603,6,6,0
22791,11081,112864,7,8,1
22791,4315,107290,8,10,2
22791,3187,110622,6,7,1
22793,20106,110912,7,9,2
22796,9911,103060,5,3,2
22796,35792,104348,9,5,4
22799,1449,99810,8,7,1
22799,21883,105112,7,9,2
22811,5923,99674,10,7,3
22811,191,110413,10,7,3
22811,19240,108394,8,9,1
22848,34545,102926,8,10,2
22848,15968,103644,5,8,3
22848,8999,100405,10,8,2
22848,31396,99052,4,7,3
22852,1057,111161,8,10,2
22852,10103,105236,7,10,3
22856,18187,110475,4,10,6
22856,1182,112462,6,7,1
22856,36087,106220,5,10,5
22856,6579,113101,4,6,2
22856,19949,106453,1,4,3
22859,20901,78718,8,7,1
22862,33878,101414,8,5,3
22862,10579,110357,8,9,1
22869,14961,93894,7,6,1
22869,4884,95159,8,7,1
22869,4884,101540,5,7,2
22884,2816,93773,10,8,2
22884,25404,100403,10,6,4
22900,28698,91763,9,6,3
22900,11009,105378,8,6,2
22900,22234,87003,9,9,0
22900,28373,95467,8,10,2
22900,3543,110478,9,7,2
22900,5528,97904,10,7,3
22900,27909,104466,9,9,0
22905,8623,99674,9,7,2
22905,20098,102926,7,6,1
22926,21939,104431,10,7,3
22926,7790,99785,10,8,2
22927,24406,97165,8,10,2
22927,16716,108550,8,8,0
22938,7103,98258,9,9,0
22938,11009,83190,7,9,2
22938,11009,87414,7,7,0
22953,5399,113277,10,9,1
22953,18759,111161,8,10,2
22953,21785,102266,6,10,4
22953,8038,107048,8,9,1
22953,13376,101272,7,7,0
22953,4316,101393,8,7,1
22969,32180,113247,8,7,1
22981,1839,100502,10,5,5
22981,13793,95742,7,7,0
22994,25058,105695,8,8,0
22994,2927,100802,7,8,1
23021,437,105236,9,7,2
23021,437,110413,9,9,0
23034,18257,112740,7,7,0
23087,14341,109707,8,8,0
23164,11066,109830,9,8,1
23164,16282,111257,8,8,0
23164,17704,107688,8,9,1
23215,17086,110413,10,9,1
23215,35367,106977,9,8,1
23215,6184,108160,5,8,3
23215,23647,112697,7,7,0
23215,4667,104694,8,8,0
23215,4667,105112,8,4,4
23215,4667,106856,9,7,2
23215,4667,107362,7,2,5
23215,4667,107818,9,8,1
23215,4667,108550,9,9,0
23215,4667,109444,7,5,2
23215,442,103873,8,10,2
23215,16250,111282,8,10,2
23215,3292,103112,7,9,2
23215,14516,109446,6,8,2
23215,20299,102768,6,8,2
23215,19182,109951,8,5,3
23215,3632,110167,6,10,4
23245,26049,105236,9,10,1
23245,8532,112471,8,7,1
23245,14316,112641,8,7,1
23245,21908,112851,7,1,6
23250,27817,76141,8,9,1
23250,13376,62803,10,10,0
23293,21778,109830,10,9,1
23293,7456,112384,7,8,1
23310,9932,113497,6,8,2
23310,24477,106489,8,8,0
23310,35176,107362,3,10,7
23310,29896,105812,10,8,2
23310,32010,112508,7,7,0
23310,21196,101272,6,10,4
23311,29086,113277,9,10,1
23311,1241,113247,8,8,0
23330,4552,110912,9,10,1
23330,7447,111161,9,10,1
23330,11438,109830,10,9,1
23390,10996,111161,8,10,2
23394,16157,99685,9,10,1
23394,221,99674,9,8,1
23394,5991,95953,9,9,0
23394,28914,89881,10,9,1
23394,2867,97814,9,9,0
23395,20779,111161,10,10,0
23415,5698,100802,8,8,0
23415,25404,113409,4,7,3
23423,11432,102685,6,4,2
23423,11749,88247,8,7,1
23423,7108,100802,6,8,2
23423,5655,105690,5,7,2
23423,2401,90329,7,8,1
23423,7103,98554,8,8,0
23423,19967,82010,7,7,0
23423,13376,83284,3,9,6
23423,13376,111149,6,9,3
23423,17667,97351,3,9,6
23426,10579,70328,7,8,1
23426,3461,76085,7,10,3
23444,27957,103064,7,8,1
23444,16048,78748,3,8,5
23444,7706,59742,9,6,3
23465,27909,93822,9,7,2
23485,27646,109707,10,9,1
23485,13648,99871,9,7,2
23486,29189,113189,10,10,0
23486,29224,90264,10,8,2
23486,29224,97742,10,6,4
23510,31648,113247,7,9,2
23520,19185,107048,7,7,0
23520,25735,111512,7,7,0
23520,26872,110216,5,8,3
23520,35477,112740,7,7,0
23520,13793,102034,4,2,2
23533,12514,110413,9,9,0
23533,29823,107822,9,8,1
23533,6579,107507,7,8,1
23533,17800,106697,3,8,5
23533,17801,107798,8,9,1
23533,10762,108071,8,10,2
23533,7529,106452,8,7,1
23555,6579,112740,9,6,3
23560,12903,87800,7,8,1
23560,12903,110357,9,10,1
23560,35176,97733,6,10,4
23563,34449,102926,9,8,1
23563,34449,105236,9,8,1
23563,34449,108052,10,8,2
23563,34449,109830,7,7,0
23563,34449,110413,8,8,0
23563,34449,111161,10,10,0
23563,19240,110912,10,9,1
23563,33653,103064,10,8,2
23563,33653,110357,10,9,1
23563,33653,112573,10,8,2
23563,28914,105695,10,8,2
23563,22312,107554,8,9,1
23574,1415,81505,10,7,3
23574,29896,83658,10,9,1
23574,17946,93870,8,9,1
23574,13376,85636,4,6,2
23583,13801,95953,6,9,3
23583,13376,98554,9,7,2
23588,280,112864,10,9,1
23588,23645,111257,10,7,3
23588,27534,110632,10,8,2
23588,4667,112722,10,5,5
23588,336,112401,10,10,0
23588,3647,110737,10,8,2
23598,7103,111495,7,8,1
23598,11009,99165,5,5,0
23614,7103,107209,7,7,0
23629,5101,76759,9,10,1
23632,13648,77889,7,7,0
23638,29349,75860,5,10,5
23638,30148,91059,5,8,3
23638,11593,88794,3,9,6
23645,21744,109830,9,9,0
23645,2677,111257,7,8,1
23647,35367,109830,9,10,1
23647,2634,110413,10,8,2
23647,9054,110912,10,9,1
23647,33402,107048,8,8,0
23647,23215,112697,7,7,0
23647,2657,106226,7,7,0
23647,29760,106697,6,8,2
23647,29760,112384,7,9,2
23647,29760,112462,5,8,3
23647,16250,108052,10,10,0
23647,8282,112573,10,8,2
23647,26872,109190,5,3,2
23647,26872,112442,6,8,2
23647,9283,107822,8,10,2
23647,13648,111742,7,7,0
23647,7103,105435,7,8,1
23647,31613,104181,5,6,1
23647,10623,109676,5,6,1
23647,22856,106453,5,1,4
23647,24967,107315,6,7,1
23650,35935,111161,10,9,1
23650,17086,110912,10,9,1
23650,1763,102926,9,9,0
23675,15141,86879,9,10,1
23675,24914,101700,10,10,0
23678,34449,99674,7,8,1
23678,34449,108052,10,8,2
23678,34449,109830,8,7,1
23678,34449,110413,10,8,2
23678,34060,97937,8,9,1
23678,23563,112573,10,10,0
23678,8780,105323,9,10,1
23678,16806,97165,9,9,0
23678,24481,95953,9,9,0
23678,9283,99653,7,6,1
23678,9283,107818,8,10,2
23678,9283,107822,8,10,2
23678,9283,112818,8,10,2
23678,27743,94608,8,7,1
23678,11220,100681,9,8,1
23678,20084,113627,7,9,2
23678,16903,104454,8,8,0
23707,13376,106856,7,8,1
23735,32532,105236,9,9,0
23794,1089,103776,7,7,0
23798,21422,112864,7,8,1
23798,2439,111161,8,10,2
23798,8232,112573,8,7,1
23798,6643,113277,7,9,2
23798,12514,109686,7,8,1
23801,8523,112641,10,8,2
23801,6680,100403,10,5,5
23801,4667,95705,6,7,1
23804,30256,103644,6,6,0
23804,18529,101410,7,9,2
23804,12364,95467,7,9,2
23824,1492,87544,8,9,1
23839,7607,112641,9,8,1
23839,16616,105236,9,6,3
23839,11073,94737,7,7,0
23839,1241,102536,7,8,1
23858,35574,91042,10,8,2
23869,30928,110912,9,9,0
23869,1365,105695,9,9,0
23869,31096,113375,7,7,0
23869,34849,105226,7,8,1
23884,1182,96895,6,7,1
23884,26592,111756,8,5,3
23895,9236,99685,9,10,1
23895,10652,104348,8,8,0
23896,25147,102926,8,10,2
23897,27094,102926,10,8,2
23913,555,111161,9,10,1
23913,12753,107290,8,10,2
23913,27839,112864,10,8,2
23913,14599,109035,8,6,2
23913,17801,106697,9,8,1
23915,20469,109707,9,7,2
23942,24481,105323,7,9,2
23942,16533,108052,9,10,1
23942,22742,112471,7,7,0
23942,33402,97576,8,9,1
23942,10514,99487,10,9,1
23945,18705,100157,5,7,2
23952,10186,107207,9,9,0
23952,26902,94332,8,7,1
23962,26463,113277,3,8,5
23962,35082,99785,8,8,0
23962,4305,104431,6,7,1
23966,4552,110912,9,10,1
23966,7447,111161,10,10,0
23966,11438,109830,10,9,1
23966,9932,110475,7,7,0
23966,7790,110989,6,4,2
23977,17800,104691,7,7,0
23977,16214,112508,7,6,1
23977,7103,112573,9,8,1
23978,25521,83658,9,8,1
23978,27881,85933,6,5,1
23978,28968,90329,7,8,1
24001,14604,109830,5,7,2
24001,34477,108550,2,10,8
24001,14498,95953,8,9,1
24002,33254,105236,8,8,0
24025,19168,105236,7,7,0
24041,35367,106977,8,8,0
24041,7790,108333,6,5,1
24041,7790,112384,9,8,1
24041,16623,107614,8,9,1
24049,4302,112442,8,8,0
24049,24511,109830,8,10,2
24082,4667,112281,8,4,4
24082,26902,112697,5,9,4
24085,18022,112573,9,10,1
24085,26512,109686,10,10,0
24111,1182,108052,10,8,2
24111,19351,97216,8,9,1
24111,5287,83987,7,8,1
24111,9086,79522,7,7,0
24118,16838,103873,10,10,0
24118,27817,82176,10,10,0
24118,27817,82242,7,7,0
24118,12587,86541,10,9,1
24118,20446,82912,10,10,0
24143,19682,111161,7,8,1
24143,17946,91369,9,9,0
24143,11009,91306,7,3,4
24164,7529,87597,8,10,2
24164,7529,91949,6,10,4
24164,7529,96101,5,6,1
24167,18667,109830,9,8,1
24174,22744,97742,8,6,2
24174,22744,113189,9,8,1
24174,10579,104187,7,6,1
24174,10579,107659,6,8,2
24174,10579,112864,8,8,0
24174,1089,99700,7,5,2
24174,13648,109836,6,8,2
24212,3392,113568,10,7,3
24212,14326,109830,9,10,1
24212,18785,100802,10,9,1
24212,14157,108211,9,7,2
24212,9790,109707,9,9,0
24212,16282,107387,4,6,2
24220,14286,97958,9,9,0
24220,34849,109068,8,6,2
24233,13376,109831,8,8,0
24248,9537,108037,7,10,3
24248,26902,112697,6,9,3
24248,9283,110478,8,6,2
24259,34783,112442,7,8,1
24259,4023,113189,7,6,1
24259,7311,113497,7,9,2
24259,14286,102803,7,6,1
24277,20106,107207,10,9,1
24277,20106,112641,10,10,0
24277,20389,107818,8,9,1
24277,32233,110413,10,9,1
24277,15381,109707,7,10,3
24277,24477,108330,8,6,2
24284,221,99674,8,8,0
24295,29046,95647,8,9,1
24295,4808,106226,8,4,4
24337,4552,110912,10,10,0
24337,7447,111161,10,10,0
24356,35312,107254,4,2,2
24356,10440,110912,9,9,0
24356,18596,103873,5,10,5
24356,13793,102926,9,10,1
24356,9537,112641,7,10,3
24406,34082,112471,10,9,1
24406,177,110912,10,10,0
24406,35556,111495,10,10,0
24406,35556,111507,10,9,1
24434,1790,112573,8,10,2
24434,7273,108160,7,8,1
24465,12220,95327,7,8,1
24465,12220,99685,9,8,1
24465,12220,106519,8,8,0
24465,12220,108394,10,6,4
24465,18459,94226,9,8,1
24477,24836,106489,8,8,0
24477,10637,105236,6,8,2
24477,15794,108550,5,9,4
24477,13206,111503,4,8,4
24477,20081,108330,6,7,1
24477,16556,105695,7,8,1
24481,8566,113277,9,9,0
24481,34731,105323,9,9,0
24481,34731,110413,9,9,0
24481,2731,107207,9,7,2
24481,18759,109686,7,9,2
24490,27909,101410,10,9,1
24500,11934,59719,10,1,9
24500,32570,64285,8,8,0
24511,8232,109830,10,9,1
24511,8232,112573,9,7,2
24511,18761,112864,8,8,0
24511,17667,112471,9,8,1
24511,34400,102492,9,8,1
24511,21278,104257,9,8,1
24511,21278,111070,9,6,3
24511,2827,112442,8,8,0
24511,2684,112641,8,10,2
24511,4989,97733,8,9,1
24511,4989,104714,9,8,1
24511,26722,109707,8,10,2
24511,31849,98258,9,7,2
24511,27714,110759,8,10,2
24511,35734,98635,8,8,0
24511,31979,101761,9,7,2
24511,32597,110074,8,8,0
24516,29463,113277,9,8,1
24516,35792,110912,9,8,1
24545,14630,107207,10,10,0
24545,23563,92005,8,10,2
24545,23563,108052,9,10,1
24545,23563,110912,9,10,1
24545,16716,97239,9,10,1
24545,16806,113277,9,8,1
24545,20106,99077,8,10,2
24545,36058,101540,7,8,1
24545,28450,95327,10,8,2
24545,24991,92965,9,8,1
24545,1805,104652,8,7,1
24560,18237,113247,6,10,4
24572,21908,99685,9,8,1
24572,21908,110912,10,9,1
24572,21908,111161,8,9,1
24572,28488,99674,7,8,1
24572,28488,109830,8,8,0
24572,3284,105695,8,10,2
24572,10103,112641,9,10,1
24572,1540,108399,8,8,0
24572,15784,101540,9,9,0
24605,885,109830,10,9,1
24605,18984,111161,8,9,1
24613,3349,113277,9,9,0
24613,34854,99685,10,9,1
24629,9444,105695,7,10,3
24629,36012,109830,8,10,2
24629,14674,86879,10,10,0
24629,14674,113247,10,10,0
24629,2842,92005,8,7,1
24629,23215,93437,9,9,0
24629,10133,90756,9,8,1
24672,13419,105236,9,9,0
24672,25723,112461,7,8,1
24672,24991,113118,6,8,2
24672,8050,102015,9,8,1
24739,28138,103994,7,9,2
24739,17801,104431,8,8,0
24750,9413,111282,6,9,3
24760,26769,102926,6,10,4
24760,11438,109830,9,9,0
24760,26630,110413,9,8,1
24779,13793,112471,8,8,0
24787,23962,113277,10,3,7
24809,6623,105690,8,6,2
24809,10579,107977,8,10,2
24818,32365,110912,10,10,0
24818,25404,88323,8,8,0
24831,9995,105695,8,8,0
24831,34849,107659,9,7,2
24870,33862,112641,8,9,1
24870,36106,113247,7,7,0
24870,21629,106856,8,6,2
24870,29723,105435,7,6,1
24897,18736,107207,8,8,0
24897,474,112471,6,8,2
24897,5423,93870,8,8,0
24897,34849,88993,7,9,2
24897,18077,94625,7,9,2
24899,23583,98554,8,9,1
24899,13519,103074,10,9,1
24914,9911,107614,8,7,1
24914,21364,96895,9,6,3
24914,344,103064,10,10,0
24914,23675,101700,10,10,0
24914,8050,110074,10,7,3
24914,16282,97428,6,9,3
24947,28182,110912,8,8,0
24956,33398,88944,10,8,2
24961,27909,112471,9,10,1
24987,10652,113277,8,9,1
24987,8512,103644,8,7,1
24987,16716,108550,8,8,0
24987,7353,98724,8,4,4
24991,2030,97216,8,8,0
24991,18884,94737,7,8,1
24991,34477,96283,8,9,1
24991,5675,101410,7,7,0
24991,4246,103772,8,7,1
24991,11507,113118,8,10,2
24991,7108,113305,8,9,1
25024,34429,108399,8,8,0
25024,9283,89755,8,10,2
25054,21240,99674,9,8,1
25054,11663,71562,9,10,1
25054,30482,101640,10,8,2
25058,25359,112471,8,7,1
25058,22312,112641,8,10,2
25058,18275,105695,8,8,0
25058,20294,110322,8,7,1
25071,2634,112864,8,7,1
25071,14592,109686,9,8,1
25071,3292,105698,5,7,2
25085,2716,111149,7,7,0
25085,21519,96256,7,8,1
25085,8050,104029,5,8,3
25085,12220,107617,8,8,0
25101,29035,89927,6,10,4
25101,29035,100507,6,8,2
25102,11009,113161,10,9,1
25106,4105,54698,8,10,2
25106,9283,61722,7,10,3
25106,13301,75148,8,9,1
25122,31275,107808,8,8,0
25147,12514,110413,10,9,1
25147,18689,112864,9,9,0
25147,17800,104691,8,7,1
25147,32539,112722,8,7,1
25147,27045,112641,9,7,2
25147,18116,106489,9,7,2
25250,32597,33870,10,9,1
25251,20684,95016,8,8,0
25251,10579,94721,8,9,1
25265,14329,99685,10,10,0
25265,29760,71562,10,10,0
25358,8623,105323,10,8,2
25359,20929,112471,7,9,2
25359,17519,113189,8,7,1
25361,30463,92890,7,10,3
25361,10263,93779,10,7,3
25361,6808,92718,8,7,1
25373,35469,60522,9,8,1
25399,13648,102951,8,6,2
25399,13376,105435,7,7,0
25404,21908,99685,9,8,1
25404,21908,108052,10,7,3
25404,21908,110413,10,6,4
25404,21908,111161,10,9,1
25404,33653,102926,10,9,1
25404,17667,95953,10,8,2
25404,8760,110148,8,6,2
25404,855,97733,8,9,1
25404,855,98206,8,3,5
25404,26902,98084,8,8,0
25404,26902,104036,6,8,2
25404,26902,105121,8,7,1
25404,26902,112442,5,10,5
25404,34429,103074,7,8,1
25404,34429,104009,4,5,1
25404,34429,108550,8,7,1
25404,13376,94737,10,8,2
25404,13376,95327,7,9,2
25404,13376,95705,7,9,2
25404,13376,96061,7,7,0
25404,13376,96754,9,8,1
25404,13376,99871,8,6,2
25404,13376,100403,6,7,1
25404,13376,109445,8,10,2
25404,13376,111282,7,8,1
25404,13376,111438,7,7,0
25404,16250,111503,9,10,1
25404,29760,100814,5,7,2
25404,34225,107688,10,6,4
25404,3292,104070,7,7,0
25404,29896,110632,8,6,2
25404,8135,97216,8,9,1
25404,24212,94625,9,9,0
25404,26872,105046,7,8,1
25404,7103,113409,7,6,1
25404,17704,106598,7,6,1
25404,29086,95925,7,10,3
25404,4816,107050,8,8,0
25426,29224,86034,4,7,3
25426,1895,86006,5,6,1
25426,10579,107290,6,10,4
25426,35477,111282,7,7,0
25426,35574,112462,6,1,5
25443,27580,110413,8,9,1
25443,5298,109830,8,9,1
25448,21278,104257,8,8,0
25448,25404,93773,8,8,0
25465,28914,95765,8,8,0
25465,28914,113277,7,8,1
25465,17667,97165,8,10,2
25465,23563,99674,9,7,2
25465,34565,94226,4,9,5
25465,7412,84602,7,7,0
25465,7412,89927,6,10,4
25465,7412,100507,5,4,1
25465,3909,108550,8,8,0
25465,28182,112870,8,8,0
25465,13376,101279,8,7,1
25472,33866,108052,8,9,1
25472,7985,112573,9,10,1
25514,27524,110912,10,9,1
25514,28914,80678,7,10,3
25514,17667,112471,9,8,1
25514,34397,80339,7,8,1
25514,17326,106856,7,7,0
25514,34404,103064,9,8,1
25514,23798,112864,8,7,1
25514,8232,93409,7,9,2
25514,16806,110005,7,9,2
25514,11009,105793,7,8,1
25514,25549,112697,5,7,2
25521,14630,99685,9,10,1
25521,7108,106856,7,8,1
25549,8050,93191,9,8,1
25549,8050,100935,8,10,2
25549,8050,102494,7,7,0
25549,8050,103939,6,8,2
25549,8050,113627,8,8,0
25549,3367,96969,7,8,1
25549,3367,112471,9,9,0
25549,11009,86541,8,7,1
25549,11009,87280,8,9,1
25549,11009,101410,7,8,1
25549,11009,102138,8,10,2
25549,11009,106226,9,9,0
25549,11009,106677,8,9,1
25549,11009,107048,8,8,0
25549,11009,109707,8,9,1
25549,24509,88763,9,9,0
25549,17527,101765,9,5,4
25549,34565,96283,9,8,1
25549,32570,107653,8,8,0
25549,11510,95497,8,9,1
25549,25514,112697,7,5,2
25549,2774,89853,8,9,1
25549,25465,89927,7,6,1
25549,9702,111507,7,8,1
25549,21274,107822,8,9,1
25549,29163,87553,7,10,3
25549,29163,107616,7,8,1
25549,12619,94625,8,9,1
25550,4105,93779,9,9,0
25550,19675,94663,8,7,1
25550,8050,102511,6,7,1
25550,31096,97123,10,8,2
25573,6213,98282,10,10,0
25599,27590,94737,8,8,0
25599,4859,109445,8,7,1
25608,26596,107818,7,8,1
25608,9283,92890,7,10,3
25636,16556,107818,7,8,1
25636,16623,97958,7,10,3
25656,10839,112384,8,9,1
25656,26643,97216,7,8,1
25658,25465,78788,10,8,2
25658,25465,81398,10,8,2
25658,11998,99077,8,8,0
25658,316,91480,6,9,3
25658,3337,108052,9,10,1
25658,7103,100150,7,8,1
25658,27909,101410,10,9,1
25658,15928,80610,8,7,1
25684,15085,93822,7,7,0
25685,8512,103644,5,7,2
25735,18245,112442,7,7,0
25735,4137,107048,7,10,3
25735,12220,112508,6,4,2
25735,26872,107076,6,5,1
25735,23520,111512,7,7,0
25735,13376,107978,5,6,1
25735,2827,106489,7,8,1
25735,11009,102048,6,8,2
25735,20446,105151,7,9,2
25779,31956,111161,10,10,0
25817,31157,96874,10,8,2
25834,191,111161,10,9,1
25878,20185,98382,10,5,5
25878,20185,102975,10,5,5
25896,35176,106701,8,9,1
25906,11443,110912,8,10,2
25906,18881,112573,10,9,1
25917,2634,101540,8,6,2
25917,2634,105695,7,8,1
25917,2634,112864,7,7,0
25948,33878,112851,8,7,1
25948,25549,107616,8,7,1
25950,20344,110912,9,10,1
25950,20344,112573,8,9,1
25950,26630,110413,10,8,2
25964,4529,86190,9,9,0
25964,3222,97576,9,9,0
25982,13572,71360,9,10,1
25999,15251,112462,5,7,2
26000,20901,99371,8,6,2
26006,14120,93507,7,6,1
26028,11009,106677,8,9,1
26028,7103,95159,8,6,2
26049,15381,102926,8,10,2
26049,15381,110413,10,10,0
26049,23245,105236,10,9,1
26049,16225,109830,10,10,0
26051,10898,110912,1,10,9
26051,20775,113277,9,8,1
26075,8920,102926,7,9,2
26075,8920,106677,7,9,2
26075,34242,90756,5,7,2
26075,28925,81505,7,7,0
26075,19009,95953,8,7,1
26075,9307,92005,8,8,0
26075,13793,90605,6,10,4
26075,6905,88847,5,10,5
26075,6905,97165,10,8,2
26075,19351,107048,7,6,1
26075,36058,113247,7,6,1
26075,30482,101640,6,8,2
26075,15644,89927,5,8,3
26075,13376,93010,6,8,2
26075,20446,78875,8,10,2
26133,133,86190,8,10,2
26133,18847,107290,9,9,0
26189,34565,112471,9,10,1
26209,29313,110413,9,8,1
26218,11411,63522,9,9,0
26218,11411,64045,6,6,0
26218,11411,77289,5,8,3
26221,11009,67900,10,8,2
26224,16556,106489,7,7,0
26224,22312,106519,4,7,3
26239,14295,102926,9,8,1
26239,14295,112573,7,10,3
26252,4516,108550,8,7,1
26252,7704,108160,7,9,2
26253,24481,97937,10,9,1
26253,9006,99871,10,8,2
26253,11707,104036,8,5,3
26263,27524,110413,6,10,4
26263,11934,79522,9,5,4
26282,20151,76786,9,6,3
26282,8050,79641,6,8,2
26286,2842,108394,7,7,0
26286,19240,111495,8,9,1
26286,19240,111507,6,8,2
26286,35468,86904,7,8,1
26322,29224,76752,8,7,1
26322,29224,86034,6,7,1
26325,13657,111161,10,9,1
26325,3909,107554,9,9,0
26330,33304,110357,9,10,1
26352,19581,112641,9,8,1
26352,14329,109445,8,8,0
26352,7790,113540,8,7,1
26374,13739,107207,10,10,0
26374,437,110413,9,9,0
26374,33991,82971,6,9,3
26461,13168,113277,10,10,0
26463,23962,113277,8,3,5
26463,29781,105236,8,7,1
26491,22994,94291,9,7,2
26512,24085,109686,10,10,0
26512,32993,96895,10,8,2
26520,12652,109686,8,9,1
26520,16282,100405,7,8,1
26520,16282,107144,6,8,2
26520,20446,111149,7,9,2
26520,13648,102059,7,8,1
26540,35574,111503,10,8,2
26540,31157,111438,10,6,4
26540,35477,112722,9,6,3
26552,22229,80678,7,9,2
26566,8643,111161,9,9,0
26592,29209,113101,3,9,6
26592,32495,101410,9,10,1
26592,8811,109707,8,5,3
26592,23884,111756,5,8,3
26592,36058,101700,7,7,0
26592,20446,101889,6,10,4
26592,20901,104427,5,7,2
26596,19240,112471,8,9,1
26596,25608,107818,8,7,1
26621,16452,109642,9,8,1
26621,20151,100814,10,9,1
26621,8488,96438,10,9,1
26630,18248,110413,8,8,0
26632,1790,111161,10,9,1
26632,26902,113118,8,10,2
26643,221,99674,7,8,1
26643,468,99487,7,9,2
26643,16175,90605,9,8,1
26643,6623,97958,8,7,1
26643,27293,103644,6,7,1
26643,10554,103874,8,10,2
26643,19185,97576,7,10,3
26643,19185,99700,7,8,1
26643,17969,95953,7,9,2
26643,14326,112384,7,8,1
26643,18304,90756,7,8,1
26643,4605,112740,8,8,0
26643,33402,101272,6,10,4
26643,33402,106220,7,9,2
26643,27094,100258,7,6,1
26643,8944,92563,7,8,1
26643,18785,112602,6,4,2
26643,25404,97216,8,8,0
26643,13376,90655,6,10,4
26643,13376,92610,6,8,2
26643,13376,93855,4,1,3
26643,16806,95647,7,9,2
26643,21261,112896,6,8,2
26643,20294,99348,7,7,0
26643,6680,99052,7,6,1
26643,7108,113305,8,9,1
26643,35469,112288,8,6,2
26666,17801,100802,9,8,1
26666,17801,103772,10,6,4
26666,17801,111070,7,8,1
26675,22423,71853,8,8,0
26675,12220,93822,7,5,2
26675,32853,109445,7,7,0
26712,1624,93870,7,7,0
26712,2867,88000,7,8,1
26712,2867,98213,7,9,2
26744,853,107207,8,10,2
26744,5698,110912,9,8,1
26744,32532,105236,8,9,1
26744,15856,107818,8,8,0
26769,18022,102926,10,10,0
26769,24760,93058,9,9,0
26786,2657,102685,7,10,3
26786,20145,112281,6,7,1
26808,26209,110413,9,9,0
26808,11066,109830,10,8,2
26808,19185,103064,9,9,0
26808,19185,107290,10,10,0
26808,8232,102926,9,9,0
26808,16214,107688,7,9,2
26808,11073,109040,7,8,1
26808,3292,104940,7,10,3
26865,4667,102685,7,8,1
26872,35176,109040,10,10,0
26872,35176,109480,7,8,1
26872,35176,110357,10,10,0
26872,35176,110657,7,10,3
26872,35176,113497,8,10,2
26872,17801,109830,9,9,0
26872,17801,110475,9,8,1
26872,17801,111070,9,8,1
26872,17801,111257,10,9,1
26872,17801,111503,7,6,1
26872,17801,112641,9,8,1
26872,26902,112442,8,10,2
26872,19475,109190,3,7,4
26872,9145,110216,8,7,1
26872,13648,112722,7,5,2
26872,6579,113041,8,5,3
26872,6579,113161,2,8,6
26872,13376,110622,6,6,0
26872,10579,107985,8,7,1
26872,10579,109520,8,8,0
26872,10579,110364,8,8,0
26872,10579,112572,6,7,1
26872,35574,112508,7,4,3
26872,16282,107478,8,7,1
26872,408,108002,6,8,2
26872,12730,112461,10,8,2
26872,18705,112792,8,6,2
26872,16806,112579,6,8,2
26872,13237,108258,6,7,1
26872,2547,108238,8,6,2
26872,5737,109287,7,4,3
26872,6414,110442,6,9,3
26872,27817,110329,4,10,6
26893,32648,104691,6,6,0
26893,36106,113247,9,7,2
26893,2842,100150,10,8,2
26893,12220,97239,9,8,1
26893,18136,94226,6,8,2
26893,13795,97441,6,9,3
26893,20106,106977,6,8,2
26893,32495,87884,8,10,2
26902,30239,103064,10,8,2
26902,30239,109830,10,10,0
26902,30239,110357,10,8,2
26902,30239,110912,10,10,0
26902,4667,104691,10,6,4
26902,4667,109506,10,10,0
26902,4667,111257,8,9,1
26902,4667,113277,10,9,1
26902,33653,102926,10,9,1
26902,4502,100758,8,8,0
26902,341,107290,10,7,3
26902,10579,103060,7,8,1
26902,10579,104431,7,8,1
26902,10579,105695,10,9,1
26902,10579,106308,8,8,0
26902,10579,106364,9,9,0
26902,5101,103776,10,8,2
26902,5101,112462,5,7,2
26902,13376,100157,10,9,1
26902,13376,103919,8,7,1
26902,13376,105121,7,7,0
26902,13376,111686,6,7,1
26902,13376,112442,10,6,4
26902,34849,100258,7,7,0
26902,34849,113118,10,9,1
26902,3187,110148,8,8,0
26902,344,112641,10,10,0
26902,25404,104036,8,6,2
26902,16969,112697,9,8,1
26902,35477,108551,10,6,4
26903,12742,109506,8,9,1
26903,14553,109686,9,10,1
26936,32269,99582,5,6,1
26936,18674,112697,6,10,4
26963,21778,94737,8,9,1
26963,8050,110074,6,7,1
26977,12306,110932,7,8,1
26986,7292,95765,8,8,0
26986,18098,104691,7,9,2
26986,27909,97965,8,7,1
26986,20446,98213,7,8,1
27002,11220,112573,10,7,3
27002,12220,110912,6,8,2
27039,23655,112851,8,7,1
27045,25147,112641,7,9,2
27045,2680,110005,7,8,1
27045,29440,107290,7,10,3
27045,654,96874,6,8,2
27045,9163,99088,6,7,1
27045,9145,99892,5,7,2
27045,23215,106977,7,9,2
27045,23215,109444,6,7,1
27045,7607,112508,4,6,2
27045,19185,104431,6,8,2
27045,3187,100260,6,7,1
27045,36058,104348,8,3,5
27045,20901,101410,6,8,2
27045,25404,104036,7,6,1
27045,20446,101921,8,9,1
27045,17110,109759,6,5,1
27045,34849,97737,5,7,2
27045,18136,110932,7,9,2
27094,33653,86250,9,8,1
27094,33653,95016,10,8,2
27094,33653,97576,5,7,2
27094,33653,99685,10,9,1
27094,33653,102926,8,9,1
27094,28488,99785,9,7,2
27094,14436,109686,7,8,1
27094,35067,92991,8,9,1
27094,35067,106308,7,9,2
27094,25404,86837,8,6,2
27094,25404,108550,8,8,0
27094,4246,110527,6,8,2
27094,16716,94012,8,6,2
27094,26902,100258,6,7,1
27094,21278,111070,9,6,3
27094,6623,99697,3,5,2
27094,23215,107362,8,7,1
27094,27714,90021,7,10,3
27114,35550,92991,8,9,1
27114,10579,106308,7,8,1
27116,4752,97165,10,8,2
27116,33506,95647,10,8,2
27116,23895,97239,9,8,1
27116,12220,88939,10,8,2
27116,27909,98327,6,9,3
27116,8050,113627,9,8,1
27116,33254,97240,10,8,2
27122,4808,106226,10,4,6
27125,12321,112384,9,8,1
27125,19185,95016,8,9,1
27125,19372,106977,8,9,1
27137,32570,88184,8,7,1
27137,32570,110057,8,9,1
27137,29047,91355,9,9,0
27137,5137,95765,5,10,5
27137,9808,109445,7,5,2
27137,11445,96256,6,8,2
27137,20713,109688,9,8,1
27137,25549,101410,10,7,3
27137,25549,107822,8,8,0
27137,11009,94964,9,9,0
27137,2309,113409,7,4,3
27137,6155,94721,2,10,8
27137,5534,90967,9,7,2
27137,34849,105226,9,8,1
27137,1425,110832,7,8,1
27137,3943,92843,8,5,3
27156,3128,111161,10,10,0
27160,3367,56801,7,8,1
27184,32598,110357,10,8,2
27184,5188,109830,10,6,4
27184,6643,113277,8,9,1
27184,12514,112573,9,8,1
27184,14326,112384,7,8,1
27184,17801,106582,7,7,0
27184,17801,106697,7,8,1
27184,13394,112461,9,8,1
27184,26872,110216,10,8,2
27200,23486,97742,5,10,5
27200,1089,99423,7,7,0
27246,34778,97123,10,8,2
27246,25549,95497,9,8,1
27246,32570,101318,8,7,1
27246,11009,98994,3,7,4
27267,11461,108052,9,10,1
27267,11461,110413,9,10,1
27267,34043,113277,6,10,4
27267,35380,109830,6,10,4
27269,221,99674,8,8,0
27293,4605,90605,9,9,0
27293,17590,103644,7,7,0
27296,17165,112641,9,7,2
27296,23678,105323,7,9,2
27307,2574,110322,9,7,2
27307,19185,113492,4,7,3
27314,23798,95016,8,8,0
27316,13793,89686,5,5,0
27316,13793,103919,6,7,1
27316,18596,88117,5,7,2
27316,13376,91474,7,7,0
27316,15124,95583,6,5,1
27338,17698,68646,9,9,0
27338,17946,75314,8,9,1
27338,17946,90756,8,9,1
27339,10161,110912,8,9,1
27339,34107,109830,7,8,1
27339,34107,111161,8,8,0
27339,8495,99810,8,9,1
27339,25404,91203,8,7,1
27357,7790,113277,10,8,2
27357,13376,99685,10,10,0
27392,6013,93058,7,6,1
27392,35550,90605,8,9,1
27403,34565,112641,10,8,2
27409,664,73486,9,10,1
27409,14157,97165,8,8,0
27412,4973,46250,8,10,2
27412,20877,97223,10,7,3
27444,31396,112471,10,7,3
27453,20145,112281,8,7,1
27487,21238,103064,8,6,2
27487,15648,102926,8,10,2
27487,7353,108002,7,8,1
27496,31094,75686,9,6,3
27496,15941,71315,9,10,1
27499,23415,93779,10,6,4
27499,23415,96256,8,6,2
27524,35449,109830,9,10,1
27524,35449,110912,9,10,1
27524,2439,110413,10,10,0
27524,2677,105695,8,9,1
27524,8760,110367,7,6,1
27524,32495,108330,8,8,0
27526,15261,107048,9,8,1
27526,1624,88847,5,7,2
27526,4246,93779,10,8,2
27526,17800,91042,8,9,1
27534,5204,109830,10,10,0
27534,14133,105695,9,7,2
27534,14133,108052,10,7,3
27534,5399,111070,8,5,3
27534,25477,110632,8,8,0
27534,26977,110932,7,7,0
27534,29463,113627,8,4,4
27534,10113,112864,9,6,3
27551,32598,101414,8,8,0
27551,35215,103639,8,10,2
27603,1492,78788,10,7,3
27603,1456,82096,8,10,2
27603,17527,65234,8,9,1
27619,32378,89853,9,6,3
27646,18672,111161,9,10,1
27646,11009,104779,8,7,1
27646,11009,109707,9,9,0
27648,22471,111161,10,10,0
27674,15846,111161,8,10,2
27677,6808,112697,7,5,2
27677,9283,108160,7,10,3
27677,9283,109831,7,8,1
27677,9283,110322,8,9,1
27714,18761,112864,10,8,2
27714,31807,99423,10,9,1
27714,31807,106582,10,9,1
27714,16225,111161,10,10,0
27714,17704,103919,10,6,4
27714,26902,97958,10,9,1
27714,24511,110759,10,8,2
27714,12903,104692,10,5,5
27714,14599,105428,10,6,4
27714,31275,105219,10,6,4
27743,26630,110413,9,8,1
27743,8780,103939,8,8,0
27751,221,99674,10,8,2
27751,549,110912,6,8,2
27816,25981,101889,8,6,2
27816,23215,105112,8,8,0
27816,12903,99077,9,8,1
27816,10579,97958,7,9,2
27816,35520,108065,9,8,1
27816,30148,97731,6,7,1
27816,11009,110771,8,6,2
27816,26872,104926,9,7,2
27817,32055,87825,8,8,0
27817,32055,91338,9,8,1
27817,32055,93075,9,8,1
27817,2032,85694,9,9,0
27817,2032,90655,7,7,0
27817,18744,89907,10,10,0
27817,23915,109707,10,9,1
27817,13376,86050,8,6,2
27817,9455,105236,10,9,1
27817,29569,97136,5,5,0
27817,6414,93624,9,9,0
27817,6414,102690,8,7,1
27817,6414,110667,10,8,2
27817,30928,104797,8,8,0
27817,34849,100740,10,7,3
27817,34849,106452,8,5,3
27817,27045,88000,7,5,2
27817,13492,96734,9,9,0
27817,14120,86320,10,4,6
27817,30480,90881,8,5,3
27817,19182,100050,1,2,1
27817,26902,100758,7,8,1
27817,3905,107664,7,7,0
27817,26872,107387,10,10,0
27817,26872,110329,10,4,6
27817,22628,95904,6,5,1
27817,6690,86263,8,8,0
27824,12928,105435,10,6,4
27824,16623,112346,9,9,0
27839,21422,112864,8,8,0
27881,9105,92890,10,8,2
27881,19033,109445,9,8,1
27881,16282,107144,10,8,2
27881,26872,101272,7,6,1
27883,15356,112471,9,9,0
27888,18850,86190,7,8,1
27888,14439,90605,7,10,3
27888,21261,86960,6,7,1
27888,7353,96257,7,5,2
27909,20937,87884,10,10,0
27909,20937,108394,10,9,1
27909,20937,111495,9,8,1
27909,20937,111507,8,10,2
27909,18076,112471,10,8,2
27909,4884,91167,9,8,1
27909,4884,95765,8,9,1
27909,1241,102536,8,8,0
27909,34778,97123,8,8,0
27909,34778,97937,8,10,2
27909,34778,109688,9,9,0
27909,32495,88680,9,9,0
27909,32495,95953,9,10,1
27909,32495,101410,9,10,1
27909,14674,107207,8,10,2
27909,1492,87544,9,9,0
27909,19127,86979,8,8,0
27909,19127,101829,7,7,0
27909,19127,109424,9,8,1
27909,34323,97965,7,6,1
27909,25658,100150,8,7,1
27909,8050,93822,7,8,1
27909,27116,98327,9,6,3
27909,415,89853,9,9,0
27909,2657,90863,7,8,1
27909,33618,101258,8,6,2
27909,22900,104466,9,9,0
27909,33711,89841,7,8,1
27909,32378,107507,7,8,1
27926,430,111161,8,9,1
27948,8050,22100,8,9,1
27948,8050,44081,9,8,1
27948,20446,31381,9,10,1
27953,11081,110357,7,7,0
27953,14157,110912,8,8,0
27957,24825,103064,8,10,2
27957,1790,110357,9,8,1
27957,19429,103939,7,7,0
27961,21883,95159,7,9,2
27983,13648,107091,9,5,4
27983,34849,102603,8,6,2
28017,2772,107614,8,9,1
28050,5101,112462,4,7,3
28050,11081,112864,9,8,1
28050,10161,110912,8,9,1
28050,4502,109520,6,7,1
28050,2739,112442,7,8,1
28050,15124,112740,9,9,0
28130,18398,112471,8,6,2
28130,22502,99785,7,7,0
28130,22502,109445,7,8,1
28130,2574,113247,7,9,2
28130,9283,103074,7,10,3
28138,11936,105643,1,8,7
28138,5302,110912,10,10,0
28138,1170,112471,8,8,0
28138,15801,104868,2,2,0
28138,15801,112281,9,9,0
28138,14224,109040,8,10,2
28138,14224,110475,8,9,1
28138,12306,108037,7,7,0
28142,3463,111161,9,9,0
28142,8606,103767,7,9,2
28142,24277,100150,7,8,1
28146,8512,103644,3,7,4
28146,11599,96895,6,10,4
28146,17704,107688,7,9,2
28146,33924,105665,8,7,1
28146,11081,103776,6,7,1
28146,14329,97958,5,6,1
28146,1182,112462,4,7,3
28146,13801,93894,7,8,1
28146,24259,99422,4,6,2
28146,2867,98503,6,7,1
28146,5285,103759,6,5,1
28146,33001,95444,3,6,3
28146,10579,97987,3,7,4
28146,28138,105643,4,1,3
28159,20195,106582,7,7,0
28159,4246,113492,8,5,3
28159,23647,109190,9,5,4
28160,6621,106489,9,9,0
28160,24545,104652,9,8,1
28160,26592,101410,9,9,0
28160,25549,103939,8,6,2
28160,27045,104036,10,7,3
28166,4667,108358,8,7,1
28166,16282,107808,9,9,0
28182,6427,102926,7,8,1
28182,24947,110912,8,8,0
28182,22883,100405,8,9,1
28182,9283,107818,7,10,3
28182,25465,112870,8,8,0
28182,26872,109190,5,3,2
28258,31694,95631,10,7,3
28258,25404,110632,10,8,2
28259,11593,103241,9,8,1
28259,13252,89218,3,6,3
28266,25404,83658,9,8,1
28266,8050,83946,5,9,4
28266,7103,88011,7,7,0
28312,191,111161,10,9,1
28312,549,110912,8,8,0
28333,20016,110413,8,8,0
28333,21863,111161,10,9,1
28337,6414,72764,5,9,4
28337,22075,101698,8,9,1
28370,7706,75314,7,10,3
28370,25465,70666,6,7,1
28370,13648,71315,7,9,2
28373,22900,95467,10,8,2
28373,29047,88680,9,9,0
28387,221,99674,10,8,2
28387,18022,112573,8,10,2
28395,19581,112641,10,8,2
28437,11543,104409,4,6,2
28437,4670,107290,9,8,1
28437,10153,109830,10,10,0
28437,15648,102926,10,10,0
28448,2867,99871,8,10,2
28450,29921,110008,8,8,0
28450,5709,104952,8,8,0
28463,30943,89886,10,9,1
28488,28387,112573,9,8,1
28488,35853,111161,9,10,1
28488,18248,113277,8,8,0
28499,3292,103064,10,9,1
28541,2030,102526,6,8,2
28553,474,88847,7,7,0
28621,1790,111161,9,9,0
28621,11749,112641,8,7,1
28621,27453,110475,7,8,1
28621,2816,112384,8,9,1
28621,4246,109635,6,6,0
28626,13376,40068,9,8,1
28626,13376,72431,10,9,1
28657,26872,99785,7,9,2
28657,26872,112442,7,8,1
28669,12619,84335,10,5,5
28669,12619,87995,8,7,1
28669,22938,98258,9,9,0
28669,32570,88184,7,7,0
28669,32570,98532,10,7,3
28669,32597,102511,8,6,2
28669,21217,93191,10,10,0
28669,25443,105888,8,9,1
28669,16226,109508,9,10,1
28669,8050,79641,10,8,2
28669,8050,86197,8,8,0
28669,8050,94964,8,8,0
28669,8050,97216,9,9,0
28669,12239,79095,10,9,1
28669,11009,78326,7,9,2
28669,11009,82497,6,3,3
28669,11009,87280,7,9,2
28669,12469,84654,8,7,1
28669,10133,101765,10,10,0
28669,26986,85213,8,8,0
28669,33711,86837,6,8,2
28669,29015,82269,7,7,0
28669,20446,78902,9,10,1
28669,9883,84390,9,8,1
28669,9883,93342,8,8,0
28669,28146,76162,7,7,0
28669,28146,79182,8,8,0
28669,32055,76584,7,8,1
28669,26075,101640,10,6,4
28669,36058,103767,10,8,2
28669,36058,112379,8,7,1
28673,133,86190,9,10,1
28673,10161,110912,9,9,0
28686,11559,111257,8,8,0
28686,14599,113118,7,8,1
28688,29158,92593,10,10,0
28698,1241,113247,7,8,1
28698,28914,81398,9,8,1
28698,28914,84787,7,8,1
28698,28914,86879,8,8,0
28698,28914,91763,6,8,2
28698,28914,107048,5,7,2
28698,1449,110005,8,5,3
28698,13394,99348,9,10,1
28698,15085,81283,5,9,4
28700,17801,113189,7,8,1
28700,8050,94291,5,8,3
28702,15251,110475,6,8,2
28702,10153,111161,8,10,2
28702,15124,112740,7,9,2
28702,14436,108473,7,7,0
28705,29158,112471,5,7,2
28709,27909,112471,9,10,1
28746,33670,95016,9,10,1
28746,25426,112462,3,6,3
28746,32597,95327,8,9,1
28761,32032,92890,6,6,0
28761,3187,102510,7,7,0
28786,7240,113277,9,8,1
28786,3909,91763,8,8,0
28791,11009,61811,8,9,1
28791,11009,64040,10,10,0
28791,11009,68473,8,10,2
28791,11009,70511,9,10,1
28791,17801,59113,10,9,1
28791,20937,59592,10,8,2
28791,3367,64276,9,10,1
28791,28698,65126,7,5,2
28791,9883,110917,8,8,0
28791,21728,57565,10,10,0
28831,20469,104257,10,8,2
28831,29096,111257,10,6,4
28839,4081,107048,8,9,1
28839,21294,107207,7,7,0
28839,13394,101540,7,8,1
28871,32646,104257,7,8,1
28871,2774,107808,9,7,2
28901,14995,64116,10,9,1
28901,14120,93507,10,6,4
28901,13793,94074,2,3,1
28902,10623,106918,6,7,1
28902,11009,110148,8,8,0
28904,14085,49223,10,10,0
28904,25404,90094,5,5,0
28904,2867,72431,9,10,1
28904,15948,56687,10,9,1
28904,3943,68713,4,5,1
28909,4623,104257,8,9,1
28909,7103,102798,7,6,1
28914,4884,95765,8,9,1
28914,23563,81398,8,10,2
28914,23563,81505,8,8,0
28914,23563,86879,8,10,2
28914,23563,88763,8,9,1
28914,23563,93058,7,8,1
28914,23563,105236,10,9,1
28914,23563,105695,8,10,2
28914,23563,108052,8,10,2
28914,23563,109830,8,7,1
28914,23563,110357,8,10,2
28914,23563,110413,9,8,1
28914,23563,111161,9,10,1
28914,23563,112573,9,10,1
28914,33653,83658,8,9,1
28914,33653,84787,8,9,1
28914,33653,86190,8,9,1
28914,33653,86250,9,8,1
28914,33653,95016,8,8,0
28914,33653,113277,8,9,1
28914,31613,82096,7,6,1
28914,31613,87843,6,8,2
28914,7093,112641,6,10,4
28914,17667,107048,7,8,1
28914,30239,91763,8,9,1
28914,34565,89881,9,10,1
28920,17667,83658,8,8,0
28920,29760,86250,10,9,1
28920,13376,83550,5,6,1
28925,19182,81505,7,8,1
28925,17814,73195,7,8,1
28926,15846,107943,4,8,4
28926,30690,103767,8,8,0
28938,26808,107290,7,10,3
28952,3894,96874,10,8,2
28952,23913,95016,9,10,1
28968,24760,109830,10,9,1
28968,24760,110413,9,9,0
28968,33653,108052,9,9,0
28968,33653,111161,10,9,1
28968,33653,112573,10,8,2
28968,33653,113277,9,9,0
28968,31460,103644,7,7,0
28968,31460,112641,8,10,2
28968,19240,112384,10,7,3
28968,23563,105695,8,10,2
28968,14436,103874,7,8,1
28968,9006,104348,8,10,2
28968,7108,107473,6,7,1
28968,1216,106881,7,7,0
29015,35469,62138,8,7,1
29029,29064,93409,9,5,4
29029,2731,108550,6,7,1
29033,20,111161,10,10,0
29035,25101,100507,8,6,2
29035,17704,97757,10,9,1
29043,24085,112573,5,9,4
29043,16556,105695,7,8,1
29046,11741,104257,8,10,2
29046,24295,95647,9,8,1
29046,2176,91763,9,8,1
29046,11009,97027,7,8,1
29046,26872,102526,6,6,0
29046,9145,109303,4,7,3
29047,26596,78788,8,9,1
29047,1415,81505,9,7,2
29047,20937,87884,10,10,0
29047,20937,100157,8,8,0
29047,27137,91355,9,9,0
29047,9330,88680,9,8,1
29047,27909,76451,9,8,1
29047,15562,110074,8,7,1
29047,20446,88987,7,9,2
29058,29275,113277,7,1,6
29064,261,99685,7,8,1
29064,14305,109830,8,9,1
29064,24277,105695,8,10,2
29079,13795,97441,8,9,1
29079,13795,110912,9,8,1
29079,31157,99365,5,6,1
29079,13376,105275,6,7,1
29079,13648,105327,7,8,1
29086,29976,96320,10,6,4
29086,29976,103064,10,10,0
29086,29976,107362,10,6,4
29086,29976,111503,10,7,3
29086,7213,100802,10,8,2
29086,23311,113277,10,9,1
29086,34849,109068,10,6,4
29086,13801,99938,10,5,5
29086,4973,110216,10,5,5
29086,11009,107286,10,8,2
29096,31411,108399,8,9,1
29096,14329,110912,10,8,2
29096,341,107290,9,7,2
29096,28831,111257,6,10,4
29096,6414,113375,8,9,1
29098,7076,64757,7,5,2
29098,7076,66995,8,7,1
29108,4989,104714,7,8,1
29108,23245,112471,8,8,0
29108,19446,113568,9,8,1
29143,9537,110912,10,10,0
29148,13043,107290,10,7,3
29148,31934,97216,9,10,1
29158,34565,112471,7,10,3
29158,4884,91167,8,8,0
29158,4884,95159,8,7,1
29158,4884,101540,8,7,1
29158,28688,92593,10,10,0
29158,27909,97965,6,7,1
29158,27909,100150,8,8,0
29158,11009,88272,6,8,2
29158,11009,89360,8,7,1
29158,11009,102138,8,10,2
29158,33390,107818,7,8,1
29158,35237,104257,7,7,0
29158,32495,105151,8,10,2
29158,5419,109348,8,9,1
29158,25514,93409,7,7,0
29158,28621,109635,5,6,1
29158,32539,97493,8,6,2
29158,5967,91209,8,6,2
29158,31613,94608,7,8,1
29158,20446,91554,7,6,1
29158,35792,107497,7,8,1
29158,20901,112346,7,8,1
29163,23563,103064,8,10,2
29163,23563,105695,9,10,1
29163,16716,107818,9,9,0
29163,19351,106677,7,8,1
29163,14630,107207,8,10,2
29163,17844,97165,9,8,1
29163,9650,112641,9,10,1
29163,36058,94737,9,7,2
29163,15394,108160,8,6,2
29163,8760,110367,8,6,2
29163,25549,107616,8,7,1
29189,29224,103064,10,9,1
29189,29224,113189,10,7,3
29189,5516,100814,10,5,5
29189,20356,102138,10,8,2
29204,2841,111161,9,10,1
29204,32148,109830,10,10,0
29204,26209,110413,9,9,0
29204,28437,102926,8,10,2
29209,26592,113101,9,3,6
29224,22744,113189,7,8,1
29224,29189,103064,9,10,1
29224,35574,109040,8,7,1
29224,10579,110622,6,7,1
29224,9413,105236,8,10,2
29224,33670,107818,8,9,1
29224,9246,106519,9,8,1
29224,23423,105690,7,5,2
29246,8643,111161,9,9,0
29263,17726,93748,8,7,1
29263,26902,97958,9,9,0
29291,1817,107290,8,9,1
29291,4879,111161,10,1,9
29313,19340,110413,8,10,2
29313,22852,102926,8,8,0
29319,35556,108394,9,9,0
29319,35556,111495,9,10,1
29319,35556,111507,8,9,1
29319,21728,104652,8,8,0
29319,34849,113101,9,8,1
29321,35522,110912,7,10,3
29321,16806,106307,9,7,2
29349,16250,108052,10,10,0
29349,25404,91223,4,5,1
29349,34849,97737,8,7,1
29425,14316,112641,10,7,3
29425,26480,102926,9,9,0
29432,2224,110912,8,9,1
29433,5114,72684,8,10,2
29440,6184,111161,10,10,0
29440,24605,109830,10,10,0
29440,3372,109707,8,8,0
29463,24516,113277,8,9,1
29463,24672,113118,7,6,1
29463,27534,113627,4,8,4
29507,6905,111149,9,8,1
29509,14845,99785,8,8,0
29509,2890,102057,7,10,3
29509,30230,96438,8,9,1
29509,4105,111070,7,10,3
29509,21370,104431,9,8,1
29509,10984,106965,6,5,1
29509,10579,104940,6,9,3
29509,10440,95179,4,5,1
29516,5670,63759,7,6,1
29516,14675,79522,6,10,4
29516,8701,93058,9,10,1
29516,32597,62229,7,10,3
29516,32597,79470,3,7,4
29516,32597,100234,8,10,2
29516,30600,112818,7,8,1
29516,17075,66473,8,6,2
29524,19919,110912,10,8,2
29560,4884,108399,9,7,2
29574,22075,99785,8,9,1
29574,24356,103873,8,5,3
29582,9537,105121,7,8,1
29582,23895,104348,8,8,0
29582,8723,103939,6,7,1
29582,34849,113101,3,8,5
29582,17704,106598,5,6,1
29582,14286,113326,5,8,3
29595,11009,74860,7,10,3
29595,20446,88987,7,9,2
29629,1411,103064,9,9,0
29629,12364,95327,10,9,1
29639,26049,110413,8,10,2
29639,14967,94226,8,10,2
29639,17814,84787,7,8,1
29674,4973,103064,8,9,1
29674,4973,105698,6,7,1
29723,18878,110413,6,9,3
29723,12928,105435,6,6,0
29723,21261,106677,6,8,2
29723,31275,110116,7,7,0
29760,16157,111161,8,9,1
29760,32905,111280,8,6,2
29760,344,110912,10,10,0
29760,6891,107290,9,10,1
29760,16225,110413,9,8,1
29760,10440,103776,8,7,1
29760,10440,105695,8,9,1
29760,16250,103874,7,9,2
29760,16250,106977,8,10,2
29760,16250,112462,8,7,1
29760,25404,110148,7,8,1
29760,19240,112384,9,7,2
29760,23647,106697,8,6,2
29760,10579,103644,7,6,1
29760,18705,112740,8,7,1
29781,8951,110912,8,9,1
29781,8194,105236,7,10,3
29782,1950,93818,5,6,1
29782,10802,106856,6,8,2
29782,11009,89155,6,5,1
29782,11009,98621,6,7,1
29782,13376,91557,4,9,5
29782,13376,99810,6,8,2
29823,8643,111161,9,9,0
29841,33653,90605,9,8,1
29841,33653,97576,6,7,1
29841,33653,105236,8,8,0
29841,32539,112864,6,8,2
29841,14436,97165,8,9,1
29841,26902,89175,8,8,0
29841,19182,113627,8,9,1
29841,26872,94602,7,7,0
29841,31694,96933,6,3,3
29845,26872,110357,10,10,0
29845,9413,113277,9,9,0
29884,18022,102926,9,10,1
29889,13419,105236,8,9,1
29889,21739,99685,8,9,1
29889,28488,109830,7,8,1
29889,13138,104756,7,7,0
29894,1046,105236,9,8,1
29894,20294,104691,8,7,1
29896,26706,110632,6,9,3
29896,12321,113492,7,7,0
29896,26872,107206,7,7,0
29898,11009,96764,4,8,4
29906,26133,107290,10,9,1
29906,19372,96874,10,9,1
29906,19372,99088,10,10,0
29906,4137,95953,10,10,0
29906,30482,112471,10,9,1
29906,2927,104257,10,9,1
29906,30239,112573,10,9,1
29906,26902,110148,10,8,2
29906,4302,106918,10,7,3
29906,10579,103939,10,9,1
29921,34845,110008,8,7,1
29931,27267,102926,8,8,0
29931,27524,100157,8,9,1
29971,25404,94226,8,7,1
29976,29086,103064,10,10,0
29976,29086,107362,6,10,4
29976,29086,111503,7,10,3
29976,21891,106308,3,10,7
29976,10579,105698,8,10,2
29976,2677,106519,9,9,0
30002,14286,110955,7,9,2
30004,430,111161,10,9,1
30008,34498,99088,1,9,8
30013,17128,112471,10,9,1
30013,7353,98724,7,4,3
30020,16716,86879,9,7,2
30022,4808,112471,7,7,0
30022,33020,103074,7,9,2
30035,1916,87800,9,8,1
30035,29841,78748,6,9,3
30035,9455,98084,6,7,1
30035,35975,109642,8,10,2
30039,2487,111161,9,10,1
30039,11419,112641,9,8,1
30042,7456,112384,8,8,0
30042,30558,108525,6,5,1
30042,12652,112462,5,4,1
30052,31832,107614,9,9,0
30052,35792,109686,8,10,2
30094,21347,111161,9,10,1
30094,10729,110932,8,5,3
30102,12726,82346,7,7,0
30116,11631,107290,8,8,0
30121,8032,86250,7,8,1
30121,17801,66011,9,8,1
30139,25404,105046,8,7,1
30148,4814,103064,10,10,0
30148,4814,108550,8,10,2
30148,21240,99674,6,8,2
30148,7529,102803,7,10,3
30188,14498,99077,8,9,1
30220,12485,78748,10,8,2
30220,20684,86154,6,7,1
30230,32560,96438,9,6,3
30230,31807,93773,8,9,1
30239,855,108052,10,10,0
30239,4529,103064,8,9,1
30239,4529,109830,10,9,1
30239,4529,111161,10,9,1
30239,30691,110357,8,10,2
30239,8780,101414,8,8,0
30239,8780,110413,9,8,1
30239,8780,110912,10,6,4
30239,8780,112573,9,10,1
30254,2772,113497,7,7,0
30254,20294,102057,7,4,3
30311,2839,111161,10,7,3
30329,6972,99785,7,10,3
30337,1839,100502,4,5,1
30337,22502,107290,6,7,1
30337,16229,99487,7,9,2
30337,10579,110357,7,9,2
30337,7073,107978,4,4,0
30337,25823,110604,6,8,2
30337,13394,101540,6,8,2
30337,10541,99422,5,5,0
30357,25404,95327,9,7,2
30357,11865,107207,8,9,1
30411,221,99674,10,8,2
30411,8780,101414,10,8,2
30445,8760,56801,10,7,3
30449,9729,106519,9,8,1
30449,24516,113277,8,9,1
30449,14358,106977,8,7,1
30455,437,105236,9,7,2
30455,35067,103064,9,10,1
30455,7851,88247,9,6,3
30455,13252,85959,8,10,2
30463,654,96874,9,8,1
30463,6712,99088,7,8,1
30471,24477,99077,9,9,0
30471,26592,97441,8,6,2
30476,14592,110912,8,10,2
30476,30558,98439,7,9,2
30480,20221,111161,10,8,2
30480,12730,90305,8,8,0
30480,3187,107120,10,8,2
30480,27817,90881,5,8,3
30482,19372,96874,7,9,2
30482,17519,112471,9,5,4
30482,4667,108550,8,9,1
30482,8985,104348,8,10,2
30482,25054,101640,8,10,2
30494,7447,111161,10,10,0
30514,34880,97814,7,9,2
30545,31614,109830,10,9,1
30545,15846,110912,10,9,1
30558,17801,103855,6,8,2
30558,17801,104694,8,9,1
30558,17801,112384,5,9,4
30558,30042,108525,5,6,1
30558,33775,112697,10,7,3
30558,4973,109890,7,6,1
30558,9283,104291,9,1,8
30558,6579,113161,5,8,3
30558,7790,113114,3,4,1
30558,16282,112883,6,9,3
30558,13376,107711,7,6,1
30558,35176,106965,4,10,6
30572,14926,92991,7,9,2
30572,34763,112817,7,4,3
30572,32570,98258,9,8,1
30572,18705,93105,9,7,2
30572,23678,89424,7,8,1
30572,13376,105435,8,7,1
30572,29782,93818,7,5,2
30572,19675,89853,10,8,2
30572,9283,94947,8,3,5
30572,34849,101786,7,6,1
30572,34849,102603,9,6,3
30572,20446,100486,9,9,0
30572,11009,91886,9,7,2
30591,18022,112573,9,10,1
30594,36058,107653,9,8,1
30600,19372,109830,10,10,0
30600,4302,107290,9,8,1
30600,29189,113189,7,10,3
30600,17801,107798,6,9,3
30600,7103,109446,7,7,0
30600,7103,112818,8,8,0
30648,34565,96283,8,8,0
30648,34565,112641,8,8,0
30648,34565,113277,8,10,2
30648,28914,84787,8,8,0
30648,3187,89218,8,10,2
30648,21883,113497,7,9,2
30648,8050,104029,8,8,0
30648,26872,99329,7,7,0
30667,1183,109506,10,10,0
30667,18705,108399,10,8,2
30691,16157,105236,9,8,1
30691,23707,106677,9,8,1
30691,20098,110357,10,9,1
30691,30239,108052,10,10,0
30713,9413,111282,9,9,0
30726,5709,86200,3,7,4
30742,17801,100405,7,8,1
30760,11446,107048,8,10,2
30760,7054,99685,9,10,1
30760,20901,111756,8,6,2
30760,4516,107290,8,8,0
30777,11961,93437,8,6,2
30777,4667,102685,8,8,0
30777,25404,98206,8,8,0
30807,22286,99685,10,8,2
30807,22905,99674,9,9,0
30807,15784,101540,7,9,2
30807,4667,102510,6,6,0
30812,24899,93748,10,10,0
30812,13801,112281,7,6,1
30872,4502,86190,9,9,0
30872,23390,111161,10,8,2
30896,32751,111161,10,10,0
30896,4012,99077,9,10,1
30905,8051,113481,6,8,2
30905,31157,111280,5,7,2
30905,10579,107206,7,8,1
30907,7275,111161,9,10,1
30907,33402,107688,8,9,1
30907,9741,80745,4,6,2
30907,22799,99810,8,8,0
30907,27646,91042,4,9,5
30907,11009,66767,4,4,0
30907,13648,104940,8,5,3
30907,32570,72962,6,8,2
30907,10042,95776,3,6,3
30907,18788,79550,3,5,2
30907,5670,110008,6,9,3
30907,13376,92494,6,6,0
30907,15360,96454,5,8,3
30907,20400,112760,1,3,2
30907,35469,113041,4,6,2
30907,11510,66301,3,7,4
30925,14365,54215,10,10,0
30928,1490,110912,9,1,8
30928,11159,105236,8,10,2
30943,27487,90605,8,8,0
30943,11631,99685,10,9,1
30943,31460,110632,8,6,2
30943,28463,89886,9,10,1
30943,15644,90305,8,8,0
30946,2487,111161,9,10,1
30946,33421,110413,9,8,1
30964,4973,101829,9,7,2
30964,23966,99785,8,9,1
30964,3943,79095,7,7,0
30968,20546,111282,4,8,4
30968,5709,104952,8,8,0
30998,29224,93428,6,6,0
30998,29224,97742,4,6,2
30998,29224,110622,4,6,2
30998,25426,107290,10,6,4
30998,10186,104797,7,7,0
30998,34449,108052,10,8,2
30998,24572,81505,6,10,4
30998,35574,92007,7,7,0
30998,35477,90756,9,7,2
30998,35477,97165,9,10,1
30998,19240,108394,6,9,3
30998,21630,83987,8,9,1
30998,36058,104348,8,3,5
30998,20446,101669,7,8,1
30998,29163,107616,8,8,0
31023,2775,102975,8,10,2
31023,20185,98382,7,5,2
31027,34107,109830,9,8,1
31027,13376,109831,6,8,2
31063,22744,90264,10,8,2
31094,35477,110005,9,8,1
31094,13648,102951,7,6,1
31096,34824,97123,8,7,1
31096,9307,91860,6,7,1
31096,9307,106677,4,7,3
31096,3632,106308,7,10,3
31096,32597,81059,7,5,2
31096,11009,85407,7,6,1
31096,11009,89155,6,5,1
31096,3543,109424,7,5,2
31096,23869,113375,7,7,0
31157,19185,112864,7,9,2
31157,19185,113481,7,7,0
31157,7108,112384,8,10,2
31157,30905,111280,7,5,2
31157,4605,107076,8,6,2
31157,13376,111438,6,7,1
31157,3292,105698,5,7,2
31160,30254,113497,10,7,3
31246,34571,75314,10,8,2
31246,24991,97216,9,8,1
31267,24477,102926,10,8,2
31267,8155,99685,10,10,0
31275,15444,104868,9,6,3
31275,32269,108358,9,8,1
31275,549,110912,7,8,1
31275,2827,106856,8,8,0
31275,25122,107808,8,8,0
31275,26872,107076,8,5,3
31275,20195,112715,5,6,1
31275,20752,104348,9,9,0
31275,13648,106246,7,5,2
31275,29723,110116,7,7,0
31275,17801,102266,6,7,1
31275,26643,113305,10,8,2
31275,27714,105219,6,10,4
31275,14436,105415,7,7,0
31275,15516,107750,8,7,1
31275,6414,102614,6,8,2
31291,21292,112471,8,10,2
31291,14630,110413,10,9,1
31297,2577,79522,8,8,0
31304,11009,96933,7,9,2
31305,5931,97474,6,6,0
31305,5931,113253,7,7,0
31305,17916,99253,9,8,1
31305,17916,103956,5,5,0
31305,13376,101272,8,7,1
31307,32570,59646,9,8,1
31307,32570,70460,5,8,3
31307,7704,56172,8,10,2
31307,7704,68611,7,6,1
31307,8050,77405,8,8,0
31310,29204,102926,8,8,0
31310,29204,109830,9,10,1
31332,17963,68408,7,5,2
31332,17963,69768,6,5,1
31358,22455,107290,9,10,1
31358,28702,93507,4,7,3
31358,23215,104694,7,8,1
31358,3292,103064,9,9,0
31358,3187,97815,7,9,2
31358,7790,98282,8,8,0
31378,2927,86190,8,9,1
31378,2927,97576,8,9,1
31378,11066,90605,7,9,2
31378,19185,99088,9,9,0
31390,26051,113277,9,9,0
31390,14674,112461,8,7,1
31396,6193,112471,7,8,1
31396,22848,99052,7,4,3
31396,33212,113253,5,8,3
31408,18052,110413,6,7,1
31408,32880,108399,7,8,1
31408,4667,113627,7,7,0
31411,18878,105236,10,6,4
31411,8162,108399,9,10,1
31455,29440,81505,10,8,2
31460,8512,103644,7,7,0
31460,25152,112641,10,9,1
31460,26706,110632,6,9,3
31465,19507,109830,9,9,0
31480,33670,112384,7,9,2
31490,19324,95953,9,9,0
31490,1490,110912,9,1,8
31496,20684,96928,7,6,1
31532,7576,110357,5,9,4
31532,7790,100157,10,8,2
31534,4605,111161,10,10,0
31534,33794,107688,7,10,3
31538,24277,107818,7,8,1
31555,4302,99088,10,8,2
31555,23215,111282,8,8,0
31582,11009,106677,6,9,3
31598,8050,102015,9,8,1
31598,2867,87469,7,9,2
31598,25404,76578,8,8,0
31598,21728,104797,8,10,2
31613,28914,80684,7,8,1
31613,28914,81505,8,8,0
31613,28914,82096,6,7,1
31613,28914,86190,8,8,0
31613,28914,86879,8,8,0
31613,28914,87843,8,6,2
31613,28914,93058,8,7,1
31613,28914,95765,8,8,0
31613,28914,105236,8,10,2
31613,28914,110357,9,8,1
31613,28914,110413,9,9,0
31613,28914,112573,8,9,1
31613,14436,87469,7,7,0
31613,14436,97576,6,9,3
31613,4884,112471,8,8,0
31613,35734,94291,6,7,1
31613,17704,94608,8,7,1
31613,9283,84434,7,10,3
31613,33792,107207,8,9,1
31613,22628,104181,6,3,3
31614,17800,106697,7,8,1
31617,24672,105236,7,9,2
31617,22594,108052,10,8,2
31620,3909,109830,8,10,2
31625,4859,100935,10,6,4
31625,12364,110413,10,9,1
31644,31094,75686,9,6,3
31644,31378,83866,8,10,2
31644,33254,73195,8,7,1
31644,33015,81398,9,8,1
31648,34385,108052,10,9,1
31648,23510,113247,9,7,2
31674,34000,107818,8,8,0
31674,4605,112740,6,8,2
31674,6277,113492,6,4,2
31674,27534,111070,7,8,1
31674,13376,107978,6,6,0
31694,20050,109506,8,10,2
31694,13376,106308,6,8,2
31694,17879,110475,6,8,2
31694,12220,100133,6,6,0
31694,13648,102059,5,8,3
31710,20446,80339,9,9,0
31730,18193,110413,9,8,1
31741,11009,113277,8,10,2
31745,15987,105793,10,5,5
31745,35574,108525,10,7,3
31758,13648,86200,5,9,4
31762,24511,112573,8,9,1
31788,10186,104797,10,7,3
31807,17086,110912,10,9,1
31807,13061,103064,10,10,0
31807,27714,99423,9,10,1
31807,27714,106582,9,10,1
31807,18052,112573,10,8,2
31807,26872,98206,9,9,0
31807,23215,104694,8,8,0
31807,13376,101492,8,9,1
31807,6414,113375,9,9,0
31811,6764,78935,10,8,2
31832,6628,108052,9,9,0
31832,22368,107290,7,8,1
31832,2867,107614,9,9,0
31849,6175,107048,9,7,2
31853,29734,108052,9,7,2
31853,26902,110357,9,10,1
31878,20446,74256,8,8,0
31925,19168,112471,8,8,0
31925,18304,105665,7,8,1
31925,20294,107207,9,9,0
31932,34608,103074,8,7,1
31934,29148,97216,10,9,1
31934,21230,109348,8,9,1
31934,32570,98258,6,8,2
31934,5528,97904,8,7,1
31934,8050,79641,10,8,2
31934,8050,83946,10,9,1
31942,33402,103874,7,2,5
31942,17801,99348,8,9,1
31942,3367,109836,6,8,2
31956,25779,111161,10,10,0
31956,13376,111255,7,7,0
31959,29413,113101,9,6,3
31959,2842,105236,9,7,2
31959,20446,101889,9,10,1
31959,26872,104070,10,5,5
31959,26872,106701,9,4,5
31959,27817,109707,10,10,0
31977,3620,107818,8,6,2
31979,33752,81505,8,9,1
31979,18304,90605,9,8,1
31979,18304,90756,8,8,0
31979,18304,99685,9,8,1
31979,18304,105665,7,8,1
31979,12875,84503,8,10,2
31979,2337,101761,7,5,2
31983,8978,107818,9,7,2
31983,15394,93058,7,8,1
31991,4884,51201,10,8,2
32010,22241,109040,9,10,1
32010,22241,112281,8,10,2
32010,32112,107688,7,8,1
32010,32112,109830,10,9,1
32010,26902,109506,8,10,2
32010,26902,111257,7,8,1
32010,26902,112442,9,10,1
32010,26902,112462,4,5,1
32010,26902,113118,6,10,4
32010,17801,109686,7,8,1
32010,12652,106770,7,7,0
32010,35574,112508,7,4,3
32010,34849,107362,5,6,1
32026,6767,19760,10,10,0
32026,6767,70488,7,7,0
32032,28761,92890,6,6,0
32032,33938,100507,3,5,2
32032,18420,96283,9,9,0
32032,35164,99810,8,7,1
32032,341,98384,9,6,3
32032,17801,109813,4,7,3
32055,27817,80648,8,9,1
32055,27817,82242,7,7,0
32055,27817,82776,10,10,0
32055,27817,87825,8,8,0
32055,27817,91338,8,9,1
32055,27817,93075,8,9,1
32065,133,86190,9,10,1
32075,12903,104692,2,5,3
32075,3269,103241,3,6,3
32075,14241,112851,2,10,8
32075,36058,101700,2,7,5
32075,35520,103003,1,3,2
32075,34849,99528,3,7,4
32075,10579,108255,1,8,7
32075,35469,98622,4,6,2
32112,34107,109830,9,8,1
32112,34107,111161,10,8,2
32148,5754,110357,10,9,1
32148,34598,109830,10,10,0
32152,21278,91763,8,8,0
32164,2677,107818,9,9,0
32164,8194,107048,9,9,0
32164,21883,106664,7,7,0
32172,23330,110912,8,9,1
32180,4430,113247,7,10,3
32180,11644,112641,5,8,3
32180,23798,107290,5,7,2
32180,12591,110475,4,10,6
32180,28258,110632,4,10,6
32180,40,108399,4,6,2
32180,32853,109445,2,7,5
32180,3632,113627,7,8,1
32180,2816,108071,7,9,2
32183,10263,87332,7,8,1
32183,15381,102926,9,10,1
32183,11234,112471,8,8,0
32183,5597,84516,8,8,0
32183,28259,83131,7,8,1
32183,13793,92991,7,8,1
32183,3187,94721,6,9,3
32183,3187,107048,8,8,0
32183,8050,83946,7,9,2
32183,25404,89791,8,8,0
32183,32233,112950,7,8,1
32207,10767,111161,10,9,1
32207,1998,108550,8,9,1
32232,76,94963,5,3,2
32232,12903,94291,7,7,0
32233,17086,110413,9,9,0
32233,11461,108052,10,10,0
32233,13014,113247,10,10,0
32233,32183,112950,8,7,1
32269,4973,100029,6,5,1
32269,31275,108358,8,9,1
32269,4289,107206,7,8,1
32269,26872,112722,6,7,1
32269,13376,105690,7,8,1
32294,15251,110912,10,7,3
32294,32992,112384,7,7,0
32294,6579,105236,9,9,0
32294,3187,109445,9,8,1
32294,6623,107290,9,9,0
32313,13795,111161,10,10,0
32313,10103,108052,10,10,0
32313,33752,93870,10,5,5
32317,29163,81283,8,8,0
32334,8050,106977,8,8,0
32335,18136,112641,10,9,1
32350,3349,95953,10,8,2
32378,4095,89853,6,7,1
32378,4095,93818,6,8,2
32378,23021,84787,7,7,0
32378,31648,104797,8,9,1
32378,33733,82096,9,8,1
32378,8050,102494,5,7,2
32378,18079,107507,8,8,0
32378,16806,104466,7,8,1
32423,2680,108358,10,7,3
32429,2927,76759,10,9,1
32429,6325,79522,8,7,1
32433,14674,106519,8,10,2
32433,9650,99685,9,10,1
32433,4246,103772,7,7,0
32433,4246,109446,6,5,1
32433,20299,97576,8,10,2
32433,36058,100802,8,2,6
32433,34849,98067,7,7,0
32442,21238,111161,9,10,1
32442,28968,112573,8,10,2
32495,13394,99348,10,10,0
32495,13394,101540,8,8,0
32495,1210,97239,9,8,1
32495,33752,108330,8,8,0
32495,34565,94226,7,9,2
32495,34565,95953,10,10,0
32495,27909,101410,10,9,1
32495,8050,113627,8,8,0
32495,29158,105151,10,8,2
32495,32597,100234,10,10,0
32499,9932,112573,9,8,1
32523,28901,50083,8,10,2
32523,19250,53291,8,8,0
32532,22471,105236,9,8,1
32532,17415,102685,8,10,2
32532,22565,106364,10,7,3
32539,4470,112864,8,8,0
32539,25147,112722,7,8,1
32539,28621,103772,6,7,1
32539,13793,110632,7,9,2
32539,14516,109446,6,8,2
32543,11009,96061,9,7,2
32543,9283,107822,8,10,2
32550,3632,106308,10,10,0
32557,28914,93058,8,7,1
32557,28914,105236,8,10,2
32557,28914,105695,9,8,1
32557,28914,110357,7,8,1
32557,28914,112573,8,9,1
32557,28914,113277,8,8,0
32557,34225,102926,9,7,2
32557,34225,110912,10,10,0
32557,33653,97576,8,7,1
32560,4092,107688,7,8,1
32560,10762,108071,6,10,4
32563,28450,97814,10,8,2
32570,32597,86637,8,10,2
32570,32597,100935,7,8,1
32570,11009,74851,7,8,1
32570,11009,78346,7,10,3
32570,11009,82085,9,10,1
32570,11009,83190,9,9,0
32570,11009,83511,7,10,3
32570,11009,85794,9,10,1
32570,11009,89343,8,9,1
32570,11009,91064,8,8,0
32570,11009,93223,6,8,2
32570,11009,101829,8,9,1
32570,12364,107207,8,9,1
32570,27137,88184,7,8,1
32570,27137,110057,9,8,1
32570,25549,107653,8,8,0
32570,32269,93692,4,6,2
32570,1425,113247,8,2,6
32570,8050,94336,8,8,0
32570,8050,102015,8,8,0
32570,21230,101318,7,8,1
32570,26028,95159,8,8,0
32570,35091,105151,8,10,2
32570,30572,79781,8,8,0
32570,30572,98258,8,9,1
32570,30572,112817,7,7,0
32570,9883,98532,7,7,0
32570,31934,78841,8,8,0
32570,15085,84805,9,6,3
32570,20446,88275,9,10,1
32591,5482,93870,10,9,1
32591,3269,93777,10,7,3
32591,20533,113409,10,4,6
32597,8050,52311,8,9,1
32597,8050,53604,10,8,2
32597,8050,55630,10,8,2
32597,8050,57091,9,8,1
32597,8050,62622,10,8,2
32597,8050,63522,8,8,0
32597,8050,86637,10,7,3
32597,8050,93822,8,8,0
32597,8050,100935,8,10,2
32597,8050,102511,6,7,1
32597,8050,110074,8,7,1
32597,21230,51792,10,10,0
32597,21230,55601,10,10,0
32597,21230,56732,10,10,0
32597,21230,100234,10,10,0
32597,6511,57012,8,10,2
32597,5670,53976,8,9,1
32597,5670,74811,8,8,0
32597,4884,53198,9,7,2
32597,4884,95327,9,7,2
32597,34565,56193,9,10,1
32597,34565,62229,10,10,0
32597,34565,72684,9,10,1
32597,32570,51207,10,7,3
32597,32570,52893,10,10,0
32597,32570,54389,9,9,0
32597,32570,55032,10,9,1
32597,32570,57345,9,7,2
32597,28914,79470,7,6,1
32597,28914,81505,7,8,1
32597,28914,93058,8,7,1
32597,21728,71853,8,10,2
32597,21728,104652,7,8,1
32597,11009,88680,9,8,1
32597,11009,100150,9,8,1
32597,2870,60176,9,5,4
32597,2870,98724,7,8,1
32597,2870,108122,8,9,1
32597,29516,56663,7,7,0
32597,9883,84549,8,9,1
32597,827,58458,7,8,1
32597,1241,58898,9,7,2
32597,17527,85959,9,9,0
32597,22423,81059,5,8,3
32597,25514,106856,7,7,0
32597,25658,54632,10,9,1
32597,22628,60277,8,9,1
32597,10869,98253,8,7,1
32598,27551,101414,8,8,0
32598,35215,110357,8,10,2
32609,17624,89907,10,10,0
32609,18098,89175,10,6,4
32609,23215,87050,10,8,2
32646,28871,104257,8,7,1
32648,437,110413,8,9,1
32648,26893,104691,6,6,0
32676,12220,107290,7,8,1
32677,29079,66921,10,7,3
32677,31979,81505,10,8,2
32677,4246,71853,8,6,2
32677,29760,73195,8,10,2
32677,21240,77766,8,6,2
32677,18817,72308,7,7,0
32703,7103,106308,2,8,6
32703,11009,105265,8,9,1
32727,7790,113540,6,7,1
32728,11942,110912,10,10,0
32728,28488,112573,9,9,0
32741,11081,112573,8,9,1
32751,30896,111161,10,10,0
32751,1241,113247,9,8,1
32771,22455,109830,9,8,1
32771,2929,110912,9,10,1
32771,21610,110413,8,9,1
32771,20047,112442,10,8,2
32797,4494,99685,10,10,0
32807,133,86190,9,10,1
32817,28050,103776,7,8,1
32817,28050,112462,7,4,3
32817,19870,98105,5,9,4
32853,1057,111161,9,10,1
32853,19340,110413,6,10,4
32853,8796,89218,5,10,5
32853,4655,109445,7,8,1
32880,8733,90863,5,6,1
32880,31408,108399,8,7,1
32905,20185,98382,6,5,1
32905,20185,102975,9,5,4
32905,11978,111280,6,6,0
32912,17704,103919,4,6,2
32930,21422,112864,6,8,2
32959,34004,80684,8,7,1
32967,11382,105323,10,8,2
32967,16716,110148,9,5,4
32980,29896,105812,7,8,1
32980,13376,97493,8,8,0
32993,18275,105236,10,7,3
32993,2684,96895,8,10,2
32993,19033,109445,10,8,2
33001,30230,93773,9,8,1
33001,32550,106308,8,10,2
33001,28146,95444,6,3,3
33014,28130,112471,8,8,0
33014,3187,102057,7,8,1
33014,20446,108071,6,9,3
33014,6579,106611,8,5,3
33015,2487,111161,10,10,0
33015,26330,110357,9,9,0
33020,21294,107207,8,7,1
33020,30022,103074,9,7,2
33060,4105,54698,7,10,3
33095,14523,99674,8,8,0
33095,1486,108052,9,10,1
33095,8780,107290,7,7,0
33095,25058,97937,8,9,1
33095,8760,104257,7,7,0
33095,15846,107943,8,8,0
33117,32557,73195,8,9,1
33117,32557,105236,9,8,1
33125,7108,80684,10,9,1
33160,23962,99685,10,7,3
33212,28050,95016,9,9,0
33212,28050,99423,7,8,1
33212,26133,107290,8,9,1
33212,20546,106308,8,10,2
33212,22471,101540,6,8,2
33212,26902,111257,8,8,0
33212,28968,103644,7,7,0
33212,13793,95271,7,8,1
33212,13793,113253,8,5,3
33212,25071,109686,9,9,0
33212,3187,97474,8,6,2
33212,27094,110527,6,6,0
33226,28699,106519,7,8,1
33254,24002,105236,8,8,0
33254,11499,99685,8,10,2
33254,25058,110322,9,8,1
33254,27116,97240,8,10,2
33303,17704,103074,10,9,1
33303,17704,110005,10,7,3
33303,11865,105793,1,7,6
33303,22075,100395,10,9,1
33303,6579,101921,10,8,2
33303,31745,108525,1,10,9
33304,26330,102926,10,10,0
33304,26330,110357,10,9,1
33390,19009,108399,5,8,3
33390,15163,107818,8,8,0
33398,24956,88944,8,10,2
33398,10579,93409,8,8,0
33398,10579,97958,8,9,1
33398,10579,100802,9,10,1
33398,34429,97733,8,7,1
33398,31807,89670,7,10,3
33402,10514,107688,9,9,0
33402,9254,107048,8,9,1
33402,21196,106220,9,10,1
33402,18785,109686,7,6,1
33402,34849,110678,1,4,3
33402,17801,109813,7,7,0
33410,10579,113497,10,9,1
33421,11066,109830,8,8,0
33421,9254,103064,7,9,2
33421,26209,110413,8,9,1
33432,1332,88847,8,8,0
33432,24545,97239,8,9,1
33435,4859,113247,8,8,0
33435,22423,97937,7,9,2
33438,28333,111161,9,10,1
33438,16282,110989,10,3,7
33457,24481,102926,10,9,1
33457,24481,110413,9,9,0
33473,21230,88184,8,7,1
33473,35469,112471,9,7,2
33566,7858,111756,5,5,0
33571,5109,106677,7,8,1
33571,28968,112384,7,10,3
33606,11891,100133,9,9,0
33615,775,110357,8,10,2
33615,17801,107614,7,9,2
33618,34849,91474,9,10,1
33618,34849,99371,7,5,2
33618,29035,100507,6,8,2
33618,7868,112682,8,8,0
33618,11497,97937,9,7,2
33618,9294,104348,9,9,0
33618,32378,93818,7,6,1
33618,19260,101410,9,8,1
33618,33733,101889,8,8,0
33618,27909,101258,6,8,2
33618,11009,96933,7,9,2
33618,11009,102943,7,5,2
33618,11009,105265,9,9,0
33618,6152,103994,7,7,0
33625,4884,108399,9,7,2
33627,32183,83946,8,7,1
33640,6289,106519,8,9,1
33640,6380,112818,8,8,0
33653,28914,105236,8,10,2
33653,28914,108052,9,8,1
33653,28914,110357,9,8,1
33653,28914,110413,9,9,0
33653,28914,111161,9,9,0
33653,28914,112573,8,9,1
33653,28914,113277,9,8,1
33653,23563,99685,9,10,1
33653,23563,102926,9,9,0
33653,23563,103064,8,10,2
33653,23563,110912,9,10,1
33653,14436,97576,7,9,2
33654,9246,66473,9,7,2
33660,9283,95953,8,6,2
33660,9283,106856,8,9,1
33661,31455,74285,8,7,1
33665,17252,112573,10,10,0
33670,31460,103644,6,7,1
33670,1947,104431,7,8,1
33670,4605,105695,10,8,2
33670,29224,107818,9,8,1
33670,5228,103767,10,9,1
33670,9650,107207,9,10,1
33670,28968,112384,9,10,1
33670,36097,106489,8,8,0
33670,26808,104940,7,7,0
33670,34546,107808,8,9,1
33670,3909,104573,7,8,1
33680,6579,109951,8,7,1
33689,11009,76740,6,9,3
33700,35469,98206,10,7,3
33711,442,103873,8,10,2
33711,6927,103035,7,7,0
33711,7646,106677,7,8,1
33711,33924,112819,7,9,2
33711,11009,110365,6,8,2
33711,34849,106469,7,8,1
33711,27714,104692,5,10,5
33711,35176,110657,5,10,5
33726,221,86250,10,8,2
33733,20507,92699,8,8,0
33733,33618,101889,8,8,0
33733,9145,102057,5,9,4
33752,23245,105236,10,9,1
33752,6184,108160,7,8,1
33752,9283,106856,6,9,3
33752,17667,107048,6,8,2
33752,9006,105695,9,8,1
33752,4529,104797,5,9,4
33752,26872,106977,7,8,1
33752,32495,108330,8,8,0
33752,11009,101889,8,7,1
33769,10835,112471,10,8,2
33769,34849,91042,9,9,0
33775,30558,112697,7,10,3
33792,2634,101540,8,6,2
33792,20294,107207,9,9,0
33792,21988,104348,7,8,1
33792,17704,97493,6,8,2
33794,9932,102798,10,7,3
33794,34400,111257,9,9,0
33794,15124,107688,10,7,3
33794,32010,106697,8,3,5
33794,17801,107211,10,7,3
33794,4246,109635,9,6,3
33813,21370,108065,8,7,1
33847,29925,105323,10,9,1
33849,17946,89927,9,9,0
33862,9413,111161,10,10,0
33866,25472,108052,9,8,1
33866,13376,100157,8,9,1
33866,13376,105690,5,8,3
33878,35176,101414,5,10,5
33878,35176,113497,6,10,4
33878,29582,105121,6,7,1
33878,27307,110322,6,9,3
33878,35574,108525,6,7,1
33878,12501,112851,7,8,1
33878,13376,111149,8,9,1
33878,35276,95647,6,8,2
33878,19429,106664,5,7,2
33878,20446,112966,6,9,3
33923,2842,95765,10,9,1
33923,2842,113247,9,7,2
33923,2309,95327,10,6,4
33923,13617,96283,8,9,1
33924,17368,106393,7,6,1
33924,14439,112819,9,10,1
33924,11009,107286,9,8,1
33938,32836,89927,7,9,2
33938,29035,100507,5,8,3
33938,17801,110478,7,8,1
33969,9236,105323,8,10,2
33969,31983,107818,7,9,2
33989,7985,109117,8,9,1
33989,28182,112553,8,8,0
33991,21730,111161,10,9,1
33991,15163,113497,8,7,1
33991,35574,108308,6,2,4
34004,5101,80684,7,10,3
34004,19009,108394,7,9,2
34021,11510,66301,10,7,3
34021,18674,56255,10,10,0
34041,21908,110413,8,6,2
34041,3349,95953,8,8,0
34041,27042,79116,6,8,2
34044,18304,110413,10,9,1
34044,13394,65988,10,9,1
34044,1443,112817,10,9,1
34044,11009,95250,10,8,2
34044,30482,78841,10,9,1
34044,15360,89945,8,10,2
34060,3844,110912,9,7,2
34060,3844,111161,10,10,0
34060,20344,109830,10,10,0
34082,15904,112471,9,8,1
34086,29760,112740,9,8,1
34089,34565,83987,9,10,1
34089,34565,96283,7,8,1
34089,34565,107048,9,10,1
34089,34565,112641,9,8,1
34095,21230,101410,6,8,2
34107,10996,111161,8,10,2
34107,15199,109830,8,9,1
34113,8523,110912,10,9,1
34118,11009,91886,8,7,1
34164,7529,103776,9,3,6
34164,20700,107387,3,6,3
34200,12220,112384,7,7,0
34212,28450,86879,8,9,1
34212,22423,71129,8,10,2
34225,10103,113277,10,10,0
34225,18881,111161,10,10,0
34225,11019,107207,9,8,1
34225,11019,109830,10,9,1
34225,12292,110413,10,10,0
34225,12292,110912,10,10,0
34225,2224,107688,6,9,3
34242,27094,106308,7,7,0
34248,16533,108052,9,10,1
34258,32905,111280,6,6,0
34258,21278,105236,9,9,0
34258,13376,109445,8,10,2
34268,6269,105323,9,8,1
34268,16452,102926,10,9,1
34277,13138,112818,7,8,1
34282,7447,111161,9,10,1
34303,14274,106770,7,8,1
34303,2106,104652,7,9,2
34303,10538,112471,6,9,3
34303,3943,106387,6,6,0
34311,13376,103873,7,9,2
34323,27909,97965,6,7,1
34323,34089,96283,7,7,0
34341,4816,87843,10,9,1
34341,17854,94226,10,8,2
34341,30928,104797,10,8,2
34375,4859,89218,8,3,5
34375,24465,63522,8,9,1
34375,25658,68182,7,9,2
34385,10001,108052,9,10,1
34388,33989,112553,8,8,0
34397,474,112471,8,8,0
34400,33794,111257,9,9,0
34404,15163,103064,8,8,0
34413,23215,112697,7,7,0
34413,13793,107254,6,4,2
34413,13793,111686,7,8,1
34413,7611,100260,7,10,3
34429,18022,112641,9,10,1
34429,12292,109830,8,9,1
34429,12292,110413,9,10,1
34429,12292,110912,8,10,2
34429,12292,111161,9,10,1
34429,12292,113277,8,8,0
34429,27039,112851,7,8,1
34429,25404,108550,7,8,1
34429,24572,108399,8,8,0
34429,20062,113101,5,8,3
34429,4752,113243,7,8,1
34429,14286,113326,8,8,0
34449,22905,102926,8,7,1
34449,12292,105236,8,8,0
34449,12292,108052,8,10,2
34449,12292,109830,7,9,2
34449,12292,110413,8,10,2
34449,12292,111161,10,10,0
34460,34477,96283,7,9,2
34460,10984,109445,7,8,1
34477,7113,111161,10,10,0
34477,15525,108550,10,8,2
34498,22286,112641,9,8,1
34509,20684,100507,5,4,1
34509,10579,101821,5,7,2
34509,10579,104431,4,8,4
34509,26643,99700,4,7,3
34509,14972,95626,6,2,4
34519,14365,54215,10,10,0
34523,21891,106308,8,10,2
34523,10318,108358,8,8,0
34523,10579,107977,7,10,3
34523,18257,112740,7,7,0
34532,7718,112461,7,6,1
34546,4605,90605,8,9,1
34546,8512,103644,6,7,1
34546,20937,93191,8,8,0
34546,16806,107808,9,8,1
34546,16684,95801,8,8,0
34565,30648,96283,8,8,0
34565,30648,112641,8,8,0
34565,30648,113277,10,8,2
34565,13301,95953,10,9,1
34565,13301,107207,10,9,1
34565,13301,113247,10,7,3
34565,34089,83987,10,9,1
34565,34089,107048,10,9,1
34565,8050,74958,7,8,1
34565,8050,79522,8,8,0
34565,8050,87884,10,10,0
34565,4884,95327,8,7,1
34565,4884,112471,10,8,2
34565,28914,75686,9,8,1
34565,28914,80678,8,10,2
34565,28914,83658,10,8,2
34565,28914,89881,10,9,1
34565,32495,94226,9,7,2
34565,15085,85334,8,9,1
34565,11009,96446,10,4,6
34565,25465,79116,10,8,2
34565,18136,97937,10,9,1
34565,12364,111495,10,8,2
34565,27909,83922,6,10,4
34565,27909,87544,9,9,0
34565,3187,93779,10,7,3
34565,3187,109445,10,8,2
34565,18123,92067,10,6,4
34565,23700,79944,10,10,0
34565,32183,74812,10,8,2
34571,13793,109506,9,10,1
34593,26808,90605,9,9,0
34598,32148,110357,10,10,0
34608,30022,112471,8,7,1
34608,5482,113253,2,5,3
34636,9283,107290,8,3,5
34659,8523,93779,9,9,0
34663,9283,97239,6,8,2
34663,9283,100405,9,10,1
34663,10293,113101,8,8,0
34684,12220,96283,9,6,3
34684,12220,102536,5,6,1
34684,11009,97027,7,8,1
34731,8322,110912,10,9,1
34731,27580,110413,9,9,0
34744,2487,111161,10,10,0
34763,19250,112817,4,7,3
34778,27909,97937,10,8,2
34778,27909,109688,9,9,0
34778,26893,104691,8,6,2
34783,24259,112442,8,7,1
34783,11593,111282,8,6,2
34824,34060,107207,7,10,3
34824,35792,91042,6,7,1
34824,31979,105665,5,7,2
34824,15072,91167,7,10,3
34824,31096,97123,7,8,1
34836,1790,110357,8,8,0
34836,22869,105812,7,8,1
34836,28621,112384,10,8,2
34836,6623,106950,7,6,1
34849,26902,99785,8,8,0
34849,26902,100258,7,7,0
34849,26902,103064,9,10,1
34849,26902,104431,6,7,1
34849,26902,109506,10,10,0
34849,26902,113118,9,10,1
34849,13376,99810,9,8,1
34849,13376,100403,7,7,0
34849,13376,100802,8,9,1
34849,13376,104389,7,7,0
34849,13376,106582,7,10,3
34849,13376,106977,8,8,0
34849,13376,109445,10,10,0
34849,13376,110678,4,7,3
34849,10579,107659,7,8,1
34849,10579,111503,7,7,0
34849,10579,112864,8,8,0
34849,35367,113101,8,7,1
34849,17801,104714,6,8,2
34849,17801,109444,7,8,1
34849,4667,105112,7,4,3
34849,4667,107362,6,2,4
34849,4667,108358,10,7,3
34849,2867,109415,2,6,4
34849,14286,107953,5,7,2
34849,29086,109068,6,10,4
34849,2842,110322,8,9,1
34849,16716,112461,8,8,0
34849,18785,103859,7,7,0
34849,18785,111667,7,8,1
34849,15124,112715,5,8,3
34849,7529,106452,5,7,2
34849,24041,106673,7,7,0
34849,30558,103805,8,8,0
34849,4246,103759,8,5,3
34849,7790,111190,6,3,3
34849,4335,99939,8,10,2
34849,11510,105226,8,6,2
34849,10984,101786,6,6,0
34849,27983,102603,6,8,2
34849,9797,100740,7,6,1
34849,5195,99528,7,8,1
34849,19892,111003,6,6,0
34849,33711,106469,8,7,1
34849,11707,99703,8,5,3
34849,35469,104511,8,6,2
34854,14730,110912,9,10,1
34854,19771,112641,8,9,1
34854,12572,113071,5,5,0
34880,11560,100405,10,10,0
34880,18411,107290,8,6,2
34880,18944,100157,8,8,0
34880,19009,108550,9,6,3
34880,10703,109445,8,8,0
34880,28450,97814,9,8,1
34880,28450,110008,7,8,1
34880,16969,112697,7,8,1
34880,21810,102057,7,10,3
34880,32539,112722,6,7,1
34880,10762,110005,8,9,1
34880,3632,113627,8,8,0
34880,4335,100935,9,10,1
34880,21939,107120,6,10,4
34892,5109,93058,8,9,1
34892,16476,69495,9,8,1
34954,4752,102926,8,10,2
34954,11749,103874,6,6,0
34954,17704,97493,8,8,0
34954,25735,96463,6,7,1
35045,6369,54215,9,8,1
35045,31983,93058,8,7,1
35067,12170,106308,9,9,0
35067,13061,103064,10,10,0
35067,21891,92991,9,8,1
35080,20151,94074,5,1,4
35080,20684,94862,6,7,1
35080,35469,91080,8,5,3
35082,1790,103064,9,7,2
35082,9932,112864,7,8,1
35082,20294,106611,7,5,2
35091,21358,101410,10,10,0
35091,15562,110074,10,7,3
35091,17527,107207,10,5,5
35091,34565,95327,10,8,2
35091,11009,88680,10,8,2
35091,11009,109707,10,9,1
35091,29158,105151,10,8,2
35091,23423,73341,10,7,3
35091,32570,70460,10,8,2
35106,35574,79574,5,8,3
35106,10579,64757,6,8,2
35121,13419,105236,5,9,4
35121,29884,102926,10,9,1
35131,10984,109254,6,6,0
35131,13648,98439,6,5,1
35149,35312,91080,7,4,3
35149,34849,108358,7,10,3
35149,3292,103112,7,9,2
35161,29086,111503,9,10,1
35161,35734,98635,9,8,1
35161,28621,103772,9,7,2
35162,7035,91042,8,8,0
35162,2867,92067,9,10,1
35162,36058,103767,9,8,1
35164,341,107290,7,7,0
35164,17704,104431,6,7,1
35164,5846,107207,8,10,2
35176,9932,104431,10,8,2
35176,9932,112453,10,8,2
35176,9932,112864,7,8,1
35176,9932,113497,10,8,2
35176,8780,101414,10,8,2
35176,27184,103639,10,9,1
35176,27184,110357,10,10,0
35176,26902,103064,10,10,0
35176,3292,104714,10,10,0
35176,12652,109686,10,9,1
35176,10579,113189,10,10,0
35176,19372,107131,10,8,2
35176,2684,109040,10,10,0
35176,26872,103786,6,6,0
35176,26872,106375,8,6,2
35176,26872,106701,9,4,5
35176,26872,106965,10,9,1
35176,26872,107362,10,7,3
35176,26872,109480,8,7,1
35176,26872,110657,10,7,3
35176,10984,113114,10,5,5
35176,7790,108333,10,5,5
35197,11547,102685,10,7,3
35197,29629,103064,7,9,2
35206,18788,94226,8,9,1
35206,16250,102685,8,10,2
35208,10554,103874,8,10,2
35208,2867,82307,6,8,2
35208,36,82766,8,6,2
35215,4529,103064,10,9,1
35215,20098,110357,10,9,1
35215,30411,101414,10,10,0
35215,3844,95016,9,8,1
35215,25359,113189,10,8,2
35215,27551,103639,10,8,2
35219,23574,85636,7,4,3
35235,18256,74486,7,2,5
35237,15163,104257,7,9,2
35272,21261,87182,8,6,2
35272,1449,96446,8,6,2
35276,13793,103644,6,4,2
35276,10579,99423,6,7,1
35276,10579,112864,6,8,2
35276,17332,98554,5,6,1
35312,24356,95179,3,4,1
35312,24356,97388,1,6,5
35312,24356,107254,2,4,2
35323,25404,68646,8,10,2
35357,18107,97165,9,10,1
35357,16282,103855,8,8,0
35367,24041,106977,8,8,0
35367,14326,109830,10,10,0
35367,12057,113101,7,8,1
35367,18785,112851,6,9,3
35367,19182,104952,8,8,0
35380,5188,109830,10,6,4
35380,15251,110148,8,7,1
35380,16716,111149,6,6,0
35386,8985,68638,9,10,1
35409,5287,110912,10,9,1
35435,18022,102926,8,10,2
35435,7985,74896,10,10,0
35449,11019,109830,10,9,1
35449,10103,99685,9,10,1
35449,29781,110912,10,8,2
35468,24167,109830,8,9,1
35468,10898,105236,6,10,4
35468,28702,107614,7,6,1
35468,9976,112431,8,8,0
35468,25549,102494,5,7,2
35469,20684,108525,7,7,0
35469,20586,93010,8,8,0
35469,19752,112471,7,9,2
35469,33185,107207,9,8,1
35469,27677,100405,9,7,2
35469,27677,109831,8,7,1
35469,15525,108550,9,8,1
35469,13923,97659,7,9,2
35469,10239,88794,8,7,1
35469,23533,101862,7,8,1
35469,18403,91080,5,8,3
35469,9283,89755,7,10,3
35469,9283,98384,8,10,2
35469,9283,110932,8,9,1
35469,7103,98258,7,9,2
35469,7103,109446,7,7,0
35469,20446,105217,5,6,1
35469,20446,105665,5,7,2
35469,20446,110308,7,8,1
35469,13376,87910,6,9,3
35469,13376,92925,6,6,0
35469,13376,93075,6,8,2
35469,13376,95990,4,7,3
35469,13376,107034,7,6,1
35469,33700,98206,7,10,3
35469,11009,91875,8,8,0
35469,11009,98994,6,7,1
35469,11009,104779,7,7,0
35469,11009,107286,8,8,0
35469,11009,109579,7,8,1
35469,11009,112857,6,8,2
35469,28669,87995,6,8,2
35469,19429,90192,6,4,2
35469,19429,106664,6,7,1
35469,21616,109045,7,7,0
35469,11432,88944,6,7,1
35469,27817,100740,5,10,5
35469,8811,107302,8,6,2
35469,26872,113041,6,8,2
35469,31096,91860,6,6,0
35469,13648,108473,7,6,1
35469,1684,108211,7,8,1
35469,26643,90094,7,6,1
35469,26643,112288,6,8,2
35469,3187,92796,6,5,1
35469,11445,109642,8,8,0
35469,10984,110265,7,5,2
35469,19892,94886,7,6,1
35469,27045,97737,6,5,1
35469,27045,109759,6,6,0
35469,11707,102592,7,4,3
35469,34849,104511,6,8,2
35469,34849,107953,5,5,0
35474,23533,84516,8,8,0
35474,35477,70917,8,7,1
35474,15085,93822,8,7,1
35477,22744,97742,6,6,0
35477,29224,105236,10,8,2
35477,29224,110622,6,6,0
35477,25426,111282,7,7,0
35477,35574,108525,5,7,2
35477,35574,111503,6,8,2
35477,10579,105698,4,10,6
35477,34477,108550,7,10,3
35477,30998,97165,10,9,1
35477,32539,109446,7,6,1
35477,32539,112722,6,7,1
35477,1449,110005,8,5,3
35477,13376,101540,9,8,1
35477,31979,101761,7,7,0
35477,8051,113481,5,8,3
35477,5709,104952,7,8,1
35477,27045,109444,6,6,0
35477,35087,108551,6,10,4
35477,18705,112740,7,7,0
35477,6579,105112,6,6,0
35477,34849,111667,6,7,1
35477,20877,97223,9,7,2
35477,17801,97523,6,8,2
35477,27909,97123,8,8,0
35477,3943,100998,9,8,1
35500,1796,99487,10,8,2
35503,32797,99685,9,10,1
35503,17074,108399,8,8,0
35503,4305,99077,9,8,1
35504,9307,91042,8,8,0
35510,10235,110912,10,10,0
35520,9490,91763,9,4,5
35520,15723,89881,9,9,0
35520,11220,86979,8,7,1
35520,27816,108065,8,9,1
35520,22744,86034,6,7,1
35520,7108,107473,7,7,0
35520,10579,103003,3,8,5
35522,29321,110912,10,7,3
35522,28621,93870,9,8,1
35550,8512,103644,6,7,1
35550,30905,104257,8,7,1
35550,31674,99810,9,8,1
35550,31674,106918,7,6,1
35550,13793,98084,5,8,3
35550,19950,108394,8,9,1
35550,19950,111495,10,8,2
35550,19950,111507,9,8,1
35550,33670,95174,3,6,3
35550,27045,109444,8,6,2
35550,14139,105112,6,6,0
35550,12170,113101,9,5,4
35550,15830,101318,9,8,1
35556,22519,111507,9,6,3
35556,24406,111495,10,10,0
35556,8050,113627,10,8,2
35574,10579,97428,6,7,1
35574,10579,97742,3,9,6
35574,10579,99487,9,8,1
35574,10579,99785,8,9,1
35574,10579,100507,3,3,0
35574,10579,102975,7,8,1
35574,10579,103060,7,8,1
35574,10579,103064,10,8,2
35574,10579,104431,7,8,1
35574,10579,107688,7,10,3
35574,10579,109686,10,10,0
35574,10579,110475,8,7,1
35574,10579,111280,7,6,1
35574,10579,111503,8,7,1
35574,10579,113497,9,9,0
35574,29224,109040,7,8,1
35574,7076,102685,8,7,1
35574,13801,99938,8,5,3
35574,13801,112281,8,6,2
35574,6579,103776,8,7,1
35574,6579,112462,1,6,5
35574,35477,108525,7,5,2
35574,14845,100758,8,9,1
35574,17801,105793,8,7,1
35574,32010,112508,4,7,3
35574,3187,108308,2,7,5
35591,4859,88846,8,9,1
35591,18136,99685,9,9,0
35591,32597,98724,7,7,0
35696,13376,86393,6,7,1
35696,3187,83658,8,7,1
35696,11200,90264,8,7,1
35696,26643,69715,5,6,1
35710,4875,105323,9,9,0
35710,4623,105695,8,10,2
35710,20752,104348,5,9,4
35710,9283,105265,5,10,5
35710,16806,106307,1,7,6
35720,17844,109830,9,9,0
35734,25102,106519,7,8,1
35734,8979,105812,8,10,2
35734,6680,112818,8,7,1
35734,13014,103639,8,8,0
35750,415,60675,10,9,1
35750,415,71141,10,10,0
35750,32597,100234,10,10,0
35750,27817,67328,8,10,2
35750,20446,88178,8,9,1
35750,13376,73629,8,1,7
35765,14439,107554,7,10,3
35772,17801,92644,7,8,1
35772,17801,96438,8,9,1
35792,28488,111161,10,9,1
35792,30411,101414,10,10,0
35792,775,110357,9,10,1
35792,27751,110912,8,6,2
35792,2684,109686,10,10,0
35792,9006,104348,5,10,5
35792,29158,107497,8,7,1
35794,16616,105236,9,6,3
35794,29313,99685,8,9,1
35794,24545,91042,9,7,2
35794,29760,95016,9,9,0
35797,7221,106489,8,8,0
35797,7273,100405,7,9,2
35799,2333,112697,7,7,0
35799,6579,93693,7,8,1
35800,3426,111161,10,10,0
35842,3128,111161,8,10,2
35842,14295,109830,10,10,0
35847,26371,110413,6,9,3
35853,191,111161,10,9,1
35853,221,99674,9,8,1
35877,13376,113277,9,9,0
35880,33769,112471,9,10,1
35885,9413,113277,10,9,1
35926,24277,109707,8,7,1
35926,27909,62136,8,10,2
35926,11009,99487,8,8,0
35932,4667,94074,1,2,1
35932,13376,89907,7,10,3
35932,13376,95990,6,7,1
35935,23650,111161,9,10,1
35935,3755,105236,10,8,2
35963,474,105695,9,9,0
35975,30035,109642,10,8,2
36000,20857,78788,8,10,2
36000,22423,71129,8,10,2
36000,31582,80455,7,8,1
36000,18136,74958,7,9,2
36002,11009,102926,9,10,1
36012,22455,109254,7,8,1
36012,22455,109830,10,8,2
36012,18785,111667,8,8,0
36016,3821,110167,8,9,1
36016,18674,102744,9,10,1
36016,35574,97428,7,6,1
36016,35477,113481,6,5,1
36016,11009,112857,8,8,0
36058,23563,105695,5,10,5
36058,23563,108052,10,10,0
36058,23563,111161,10,10,0
36058,24545,101540,8,7,1
36058,28914,95016,5,8,3
36058,28914,95765,8,8,0
36058,4884,112471,8,8,0
36058,4884,113247,6,7,1
36058,2842,94737,7,8,1
36058,16716,111149,8,6,2
36058,15660,106226,2,8,6
36058,23678,94226,5,8,3
36058,2680,110729,6,7,1
36058,8760,100263,8,8,0
36058,17800,100802,2,7,5
36058,15941,104348,3,9,6
36058,8050,93191,6,8,2
36058,1275,103767,8,3,5
36058,9283,109831,5,8,3
36058,19127,107653,8,9,1
36058,9455,101700,7,8,1
36058,28669,112379,7,8,1
36064,4246,77416,6,8,2
36074,5846,99685,10,9,1
36074,26330,102926,10,10,0
36074,26902,106308,8,8,0
36087,26872,101272,10,6,4
36091,34608,113253,6,2,4
36091,2816,108071,10,9,1
36091,17800,106697,6,8,2
36091,727,106452,7,6,1
36091,29582,105121,7,7,0
36097,29425,99685,7,9,2
36097,26063,105236,7,8,1
36097,19033,106489,8,10,2
36097,10440,106308,6,6,0
36106,23510,113247,7,7,0
36106,9361,88763,8,9,1
36106,18984,95327,9,9,0
36125,11593,88847,10,8,2
36139,22457,84726,10,6,4
